border_size=1
usage=map

Wot, Wot, Wot, Wot, Wot, Wo, Wot, Wo, Wot, Wot, Wot, Wo, Wot, Wot, Wwrt, Wot, Wot, Wot, Wot, Wot, Wot, Wot, Wot, Wot, Wot, Wot, Wot, Wot, Wot, Wot, Wot, Wot, Wot, Wot
Wot, Wot, 3 Wot, Wot, Wwt, Wot, Wwt, Wwt, Wwt, Wot, Wot, Wot, Wwrt, Wwrt, Wwrt, Wot, Wwt, Wot, Wwt, Ww^Vm, Wot, Wot, Wot, Wot, Wot, Wot, Wot, Wot, Wot, Wot, Wot, Wot, Wot, Wot
Wwt, Wot, Wot, Wot, Wwt, Wwt, Wwt, Wwt, Wwt, Wot, Wwrt, Wot, Wwt, Wwt, Wwt, Wwt, Wwt, Wwt, Wwt, Wwt, Wwrt, Wot, Wot, Wot, Wot, Wot, Wwrt, Wot^Vm, Wot, Wot, Wot, Wot, Wot, Wot
Ss, Wwt, Wwt, Wwt, Wwt, Dd, Dd, Dd^Ftd, Wwt, Wwt, Wwt, Wwt, Wwf, Wwt, Gs^Ft, Wwt, Gs^Ft, Wwt, Wwt, Wwt, Wwt, Wwrt, Wwt, Wwt, Wwrt, Wwrt, Wot, Wot, Wot, Wot, Wot, Wot, Wot, Wot
Ss, Wwt, Wwt, Dd, Dd, Dd, Dd^Ftd, Dd^Ftd, Wwt, Wwf, Wwf, Wwf, Gs^Ft, Gs^Ft, Gs^Ft, Gs^Ft, Gs^Ft, Dd^Ftd, Dd^Ftd, Ds, Wwt, Wwt, Wwt, Wwt, Ds, Wwrt, Wwrt, Wot, Wot, Wot, Wot, Wot, Wot, Wot
Gs^Ft, Ss^Ewl, Wwrt, Wwrt, Wwt, Dd, Wwt, Wwt, Wwf, Wwf, Ss, Gs, Gs, Gs^Ft, Gg, Gg^Vdze, Gs^Ft, Gs^Ft, Dd^Ftd, Ds, Ds, Wwt, Ds, Wwf, Ds, Wwt, Wwt, Wot, Wot, Wwrt, Wot, Wot, Wot, Wot
Gs^Ft, Ss, Wwrt^Ewl, Wwrt, Wwt, Wwf, Wwf, Wwf, Ww, Ss, Gs^Ft, Gs^Ft, Gs, Gg, Ce, Gg, Gs^Ft, Dd^Ftd, Hd^Ftd, Dd^Ftd, Dd^Ftd, Ww, Ds, Ds, Dd^Ftd, Ds, Wwt, Wwt, Wot, Wwrt, Wwt, Wwt, Wwt, Wot
Gs^Ft, Ss, Ss, Wwrt^Ewf, Wwt, Ww, Ww, Ss, Ss, Ss, Ss, Gs^Ft, Gs, Hh, Gg, Gg, Gg, Gs^Ft, Gs^Ft, Gs^Ft, Ss, Ww, Dd^Ftd, Ce, Dd^Ftd, Ds, Ds, Wwt, Ww, Ww, Ww, Dd^Vdzd, Wwt, Wot
Gd, Gs^Ftp, Ss, Wwt^Ewl, Ss, Ss, Ww, Ss^Vdze, Ss, Ss, Gs^Ft, Gs^Ft, Gs^Ft, Gg, Gs^Ft, Gg, Gg, Gll^Ftr, Gll^Ftr, Ss, Ss, Dd^Ftd, Dd^Ftd, Dd^Ftd, Dd^Ftd, Ds, Wwf, Wwf, Wwf, Ds, Ds, Wwt, Wwt, Wot
Gd, Gs^Ftp, Gs^Ftp, Ss, Ss, Ss, Ss, Ww, Ww^Ewl, Ss, Ss, Gs^Ft, Gs^Ft, Gg, Gs^Ft, Gs^Ft, Gg, Gg, Gll^Ftr, Gs^Vdzc, Ss, Ss, Dd^Ftd, Hd^Ftd, Gs^Ftp, Dd^Ftd, Dd, Dd, Dd, Dd, Dd, Wwt, Ww, Wwt
Gd, Gd, Gs, Gs^Ft, Ss, Gll^Ftr, Ss, Ww, Ww, Ww^Ewf, Ss, Gs, Gs, Gg, Gg, Gs^Ft, Gs^Ft, Gs, Gs, Gg, Ss, Gg^Ft, Gs^Ft, Gs^Ft, Gs^Ft, Hd^Ftd, Dd^Ftd, Dd^Ftd, Dd^Ftd, Dd^Ftd, Dd^Ftd, Ds, Ww, Ww
Gd^Fts, Gd, Gs^Ft, Gs^Ft, Ss, Gll^Ftr, Gll^Ftr, Ss, Ss, Ww, Ww, Ss, Ss, Gs^Ft, Gs, Gs^Ft, Gs, Gs, Gs, Ss^Bw\, Gg, Gs^Ft, Gg, Gs^Ft, Gg^Ftp, Gs^Ft, Gs^Ft, Gs^Ft, Hd^Ftd, Ce, Dd^Ftd, Gs^Ftp, Gs^Ftp, Ww
Gd^Fts, Gd, Gs^Ftp, Ss, Gll^Ftr, Gll^Ftr, Gll^Ftr, Gll^Ftr, Gll^Ftr, Ss, Ww, Ss^Vdzd, Ss, Ss, Gs, Gs, Gs^Fmw, Gs, Gll^Fp, Ss, Gs^Fmw, Gg, Gs, Gs, Hh^Es, Gs^Ft, Hh^Vdze, Gs^Ft, Gs^Ft, Gs^Ftp, Hh^Ftp, Hh^Ftp, Gs^Ft, Ww
Gd^Fts, Gd, Gs^Ftp, Ss^Vhs, Ss, Gll^Ftr, Gs^Ft, Gll^Ftr, Gs^Ft, Ss, Ss, Ww, Ww, Gs, Gs^Fms, Gs^Fms, Gs^Fmf, Gs^Fmw, Hh^Fmf, Gll^Fp, Gs^Fmw, Gll, Gll, Gg, Hh^Es, Hh^Es, Hh^Fmf, Hh^Es, Hh^Ftp, Hh^Ftp, Gs^Ft, Gs^Ft, Ww, Ww
Gd^Fts, Gd, Gs^Ftp, Ss, Ss, Gs^Ft, Gll^Ftr, Gll^Ftr, Gs^Fmw, Gs^Ft, Gs^Fmw, Ss, Ww, Gs, Gs^Fms, Gs^Fmw, Gs^Fmf, Hh^Fmf, Hh^Vdza, Hh^Fmf, Hhd^Fmf, Hhd^Fmf, Hhd^Fmf, Hh^Es, Mm, Hh^Es, Hh^Fmf, Hh^Fp, Mm, Hh^Ftp, Ss, Ss, Ww, Dd^Ftd
Gd, Gd, 4 Gd^Ftp, Gd^Ftp, Ss, Gs^Ft, Gs^Ftp, Gs^Ftp, Gg, Gs^Ft, Gs^Ft, Gs^Ft, Ww^Bsb/, Gs, Gll, Gs^Fmf, Hh^Fp, Hh^Fmf, Hh^Fmf, Hh, Hh^Fmf, Hhd^Fmf, Hh^Fmf, Hh^Es, Mm, Hh^Fmf, Mm, Hh^Fp, Hh^Fp, Hh^Fp, Hh^Fp, Ww, Hh^Fp, Gs^Ft
Gs^Ftp, Gs^Ftp, Gs^Ftp, Gs^Ftp, Gs^Ftp, Gs^Ft, Gs, Gs, Gg, Gs^Fmw, Gs^Fmw, Gs, Gs^Ft, Ww, Ww, Ss, Ss, Hh^Fp, Gs^Fmf, Hh, Gg^Efm, Gg^Fet, Rp, Hh^Fp, Hh, Hh^Fp, Rp, Rp, Rp, Mm, Hh^Fp, Ss, Hh^Fp, Hh^Fp
Hh^Ft, Gs^Ftp, Hh^Ft, Gs^Ftp, Gs, Gs^Ft, Gs, Gd^Fts, Gg, Gd^Fts, Gg, Gs, Gs^Ft, Gs^Ft, Gs^Ft, Ww, Ww, Hh^Fmf, Hh^Fmf, Gg^Efm, Gg^Efm, Gg^Efm, Rp, Hh^Fp, Mm, Rp, Ch, Ch, Ch, Rp^Fet, Mm, Mm, Mm, Hh^Fp
Hh^Ft, Hh^Ft, Gd^Fts, Gs^Ft, Gs, Gs, Gs, Gd^Fts, Gs, Gs, Gg^Fmw, Gs^Ft, Gs^Vdzc, Gs^Ft, Gs^Ft, Gs^Ft, Gs^Ft, Ww, Hh^Fp, Gg^Efm, Hh^Fp, Rp, Rp, Rp, Rp, Rp, Ch, Kh, Ch, Rp, Mm, Mm^Vdzb, Mm, Hh^Fp
Gd^Fts, Gd^Fts, Gs, Gd^Fts, Gg, Gs, Gs, Gs, Gg, Gs^Fmw, Gs^Ft, Gs^Ft, Hh^Fms, Gs^Ftp, Gs^Ft, Gs^Ftp, Gs^Ft, Ww, Ww, Hh^Fp, Mm, Rp, Rp, Rp, Rp, Rp, Rp, Ch, Rp, Rp, Mm, Mm, Mm, Hh^Fp
Gs, Gs, Gg, Gg, Re^Gvs, Gg, Hh, Gg, Gs^Ft, Gs^Ft, Hh^Fms, Hh^Fms, Mm, Hh^Fmw, Hh^Fmw, Hh^Fp, Hh^Fp, Hh^Fp, Ww, Hh^Fp, Hh^Fp, Mm, Mm, Mm, Rp, Rp, 1 Rp, Rp, Rp, Rp, Mm, Mm, Mm, Hh^Fp
Gg, Gs^Vc, Gg, Re^Gvs, Gg, Gg, Gg, Gg, Hh^Ft, Hh^Ft, Mm, Mm, Mv, Mm, Mm, Mm, Mm, Hh^Fp, Hh^Fp, Ww, Hh^Fp, Mm, Mm, Rp^Vdza, Rp, Rp, Rp, Rp, Mm, Mm, Mm, Hh^Fp, Hh^Fp, Hh^Fp
Gg, Gg, Gg, Gg, Gs^Ft, Gs^Ft, Gs^Ft, Gs^Ft, Gs^Ft, Hh^Ft, Mm, Mm, Mm, Mm, Mm, Mm, Mm, Mm, Hh^Fp, Ww, Hh^Fp, Mm, Mm, Mm, Rp, Rp, Rp, Rp, Rp, Mm, Mm, Gs^Fp, Hh^Fp, Gs
Gs^Ft, Gs^Ft, Gs^Ft, Gs^Ft, Hh^Ft, Hh^Ft, Hh^Ft, Gs^Ft, Gs^Ft, Hh^Fms, Hh^Fms, Mm, Mm, Mm, Mm, Mm, Mm, Mm, Hh^Fms, Ww, Wwt, Hh^Fp, Hh^Fp, Mm, Mm, Rp, Rp, Rp, Rr^Fet, Mm, Hh^Fp, Hh^Fp, Gs, Gs
