border_size=1
usage=map

Gg, Gg, Gg, Gs^Ft, Gg, Gs^Ft, Gs^Ft, Gg^Ftp, Hh^Ftp, Gs^Ft, Dd^Ftd, Ce, Dd^Ftd, Dd^Ftd, Dd^Ftd, Ww, Ww, Ww, Ss, Wwt, Ss, Wot, Wot, Wot, Wot, Wot, Wwt, Wwt, Wwf, Wwt, Ds, Wwf, Wwrt, Wwrt
Gs^Fmf, Gg, Gs^Fmw, Gg, Gs, Gs, Hh^Es, Hh^Es, Hh^Vdze, Gs^Ftp, Gs^Ftp, Gs^Ftp, Hh^Ftp, Hh^Ftp, Gs^Ft, Ww, Ss, Ss, Gs^Ftp, Gs^Ftp, Gs^Ftp, Wwt, Wwt, Wwt, Wwrt, Wot, Wwrt, Wwf, Wwf, Ds, Ds, Wwrt, Wwrt, Wot
Gs^Fmf, Gg, Gs^Fmw, Gg, Gll, Gs, Hh^Es, Hh^Es, Hh^Fmf, Hh^Es, Hh^Ftp, Hh^Ftp, Gs^Ft, Gs^Ft, Ww, Ww, Gs^Ft, Ss, Gs^Ft, Hh^Vdzc, Gs^Ftp, Ss, Dd^Ftd, Wwrt, Wwrt, Wwrt, Wwt, Wwf, Wwt, Wwf, Wwt, Dd, Wwrt, Wot
Hhd^Fmf, Gs^Fmf, Hhd^Fmf, Hhd^Fmf, Hhd^Fmf, Hh^Es, Mm, Hh^Es, Hh^Fmf, Hh^Fp, Mm, Hh^Ftp, Ss, Ss, Ww, Dd^Ftd, Gs^Ftp, Ss, Gs^Ft, Hh^Ftp, Hh^Ftp, Gs^Ftp, Dd^Ftd, Wwf, Wwf, Wwt, Wot, Wwt, Wot, Wwt, Wot, Wwt, Wwt, Wwt
Hh, Hhd^Fmf, Gs^Fmf, Hhd^Fmf, Hh^Fmf, Hh^Es, Mm, Hh^Fmf, Mm, Hh^Fp, Hh^Fp, Hh^Fp, Hh^Fp, Ww, Hh^Fp, Ss, Ss, Ss, Ss, Gs^Ft, Hh^Ft, Gs^Ftp, Gs^Ftp, Dd^Ftd, Wwf, Wwt, Wot, Wot, Wot, Wot, Wot, Wot, Wot, Wwt
Gs^Fmf, Hh, Gg^Efm, Gg^Fet, Rp, Hh^Fp, Hh, Hh^Fp, Rp, Rp, Rp, Mm, Hh^Fp, Ss, Hh^Fp, Hh^Fp, Gs^Ft, Ss, Ss, Gs^Ft, Gs^Ft, Hh^Ft, Gs^Ftp, Dd^Ftd, Dd^Ftd, Wwt, Wwt, Wot, Wwrt, Wwrt, Wot, Wot, Wot, Wot
Hh^Fmf, Gg^Efm, Gg^Efm, Gg^Efm, Rp, Hh^Fp, Mm, Rp, Ch, Ch, Ch, Rp^Fet, Mm, Mm, Mm, Hh^Fp, Gs, Gs^Ft, Gs^Ft, Ss, Gs^Ft, Gs^Ftp, Gs^Ftp, Gs^Ftp, Gs^Ftp, Wwf, Wwt, Wot, Wot, Wwrt, Wwrt, Wot, Wwrt, Wot
Hh^Fp, Gg^Efm, Hh^Fp, Rp, Rp, Rp, Rp, Rp, Ch, 1 Kh, Ch, Rp, Mm, Mm^Vdzb, Mm, Hh^Fp, Gs, Gs, Gs^Ft, Ss, Ss, Ss, Gs^Ftp, Gs^Ftp, Ss, Wwf, Wwf, Wwt, Wwrt, Wwrt, Wot, Wwrt, Wot, Wot
Ww, Hh^Fp, Rp, Rp, Rp, Rp, Rp, Rp, Rp, Ch, Rp, Rp, Mm, Mm, Mm, Hh^Fp, Gs, Gs^Ft, Gs^Ft, Gs^Ft, Gs, Ss, Ss, Ss, Dd^Ftd, Dd^Ftd, Wwf, Wwrt, Wwrt, Wwt, Wot, Wot, Wot, Wot
Ww, Hh^Fp, Hh^Fp, Mm, Mm, Mm, Rp, Rp, Rp, Rp, Rp, Rp, Mm, Mm, Mm, Hh^Es, Gg^Es, Gs^Ft, Gs^Ft, Gs, Gs^Ft, Gs^Vdzd, Ss, Ss, Dd^Ftd, Dd^Ftd, Dd^Ftd, Wwf, Wwt, Wwrt, Wwrt, Wwrt, Wwrt, Wwrt
Hh^Fp, Ww, Hh^Fp, Mm, Mm, Rp^Vdza, Rp, Rp, Rp, Rp, Mm, Mm, Mm, Hh^Fp, Hh^Fp, Hh^Es, Gs, Gs^Ft, Gg, Gs, Gs^Ft, Dd^Ftd, Dd^Ftd, Ss, Dd^Ftd, Dd^Ftd, Ds, Wwt, Wot, Wot, Wot, Wwrt, Wwt, Wwt
Gg, Ww, Ww, Hh^Fp, Mm, Mm, Mm, Rp, Rp, Rp, Rp, Mm, Mm, Hh^Fp, Gg, Gs, Gs, Gs, Gs, Gs^Ft, Dd^Ftd, Gs^Ft, Hd^Ftd, Dd^Ftd, Dd, Dd, Ds, Wwt, Wwt, Wot, Wot, Wwrt, Wwrt, Dd
Gg, Gg, Ww, Hh^Fp, Hh^Fp, Mm, Mm, Rp, Rp, Rp, Rp^Fet, Mm, Hh^Fp, Hh^Fp, Gg, Gs^Ft, Gs^Ft, Gs, Hh^Es, Hh^Es, Mm, Hd^Ftd, Dd^Es, Dd^Es, Dd^Es, Dd^Dr, Dd, Ds, Wwt, Wot, Wot, Wot, Wot, Wwt
Hh^Fms, Hh^Fms, Ww, Ww, Hh^Fp, Mm, Mm, Mm, Mm, Rp^Vdzc, Mm, Gs^Fp, Gs^Fp, Gg, Gs^Ft, Gs^Ft, Gs, Gs, Hh^Ftp, Mm, Hd^Es, Hd^Es, Dd^Es, Dd^Es, Dd^Es, Dd, Dd^Vdze, Ds, Ds, Wwt, Wot, Wot, Wot, Wot
Mm, Hh^Fp, Mm, Ww, Ww, Hh^Fp, Mm, Mm^Xm, Mm, Mm, Hh^Fp, Hh^Fp, Gg, Gg, Gs, Gs, Gs^Ftp, Gs^Ft, Hh^Ftp, Mm, Hd^Ftd, Dd^Es, Dd^Ftd, Dd^Es, Dd^Es, Dd^Es, Dd^Es, Dd, Ds, Wwt, Wot, Wot, Wot, Wot
Mm, Mm, Hh^Fp, Hh^Fms, Ww, Hh^Fp, Mm, Mv, Mm, Mm, Hh^Ft, Gs, Gs^Ft, Gs^Ftp, Gs^Ftp, Gs^Ftp, Gs^Ftp, Gs^Ftp, Gs^Ft, Hh^Ftp, Dd^Ftd, Gs^Ft, Dd, Dd, Dd, Dd^Es, Dd^Ftd, Dd^Ftd, Wwt, Wwt, Wot, Wot, Wot, Wot
Hh^Fp, Mm, Hh^Fp, Gs^Fms, Ww, Hh^Ft, Mm, Mm, Mm, Hh^Ft, Hh^Ft, Gg, Gs^Ft, Gs^Ftp, Hh^Ftp, Gs^Ftp, Hh^Ftp, Hh^Ftp, Hh^Ftp, Dd^Ftd, Dd^Es, Dd^Ftd, Dd, Dd^Ftd, Dd, Dd, Ds, Dd^Ftd, Wwt, Wot, Wot, Wot, Wwrt, Wot
Gll^Ftr, Hh^Fp, Hh^Fp, Ww, Gs^Ft, Gs^Ft, Mm, Mm^Xm, Mm, Hh^Ft, Gs^Ft, Gs^Ft, Ss, Gs^Ftp, Gs^Ft, Hh^Ftp, Mm, Mm, Hh^Ftp, Dd^Ftd, Dd^Es, Dd^Es, Dd^Es, Dd, Dd^Dr, Ds, Wwf, Wwt, Wot, Wot, Wwrt, Wwrt, Wwrt, Wwrt
Gll^Vdze, Gll^Ftr, Gll^Ftr, Ww, Gs^Ft, Hh^Ft, Mm, Mm, Hh^Ft, Hh^Ft, Gs^Ft, Ss, Gs^Ftp, Ss, Gs^Ft, Hh^Ftp, Hd^Ftd, Hh^Ftp, Hh^Ftp, Dd^Ftd, Dd^Es, Dd^Es, Dd^Vdzc, Dd, Ds, Ds, Wwf, Wwt, Wwt, Wot, Wot, Wot, Wot, Wot
Gll^Ftr, Gll^Ftr, Ww, Ww, Gs^Ft, Hh^Ft, Mm, Mm, Gs^Ft, Gs^Ft, Gs^Ftp, Ss, Gs^Ftp, Gs^Ftp, Gs^Ftp, Gs^Ft, Dd^Ftd, Gs^Ft, Gs^Ft, Gs^Ft, Dd, Dd^Es, Dd, Ds, Wwf, Wwf, Wwt, Wwf, Wwt, Wot, Wot, Wot, Wot, Wot
Wwt, Ww, Gs^Ft, Gs^Ft, Hh^Ft, Hh^Ft, Mm, Hh^Ft, Hh^Ftp, Gs^Ftp, Ww^Ewf, Ss, Gs^Ftp, Gs^Vdzd, Gs^Ftp, Dd^Ftd, Dd^Ftd, Dd^Ftd, Dd, Dd, Ds, Dd, Ds, Ds, Wwf, Wwf, 2 Wwt, Wwt, Wo, Wot, Wot, Wot, Wwt, Wwt
Wwt, Gs^Ft, Hh^Ft, Hh^Ft, Mm, Mm, Hh^Ft, Hh^Ft, Hh^Ftp, Gs^Ftp, Gs^Ftp, Ss, Ss, Gs^Ftp, Gs^Ftp, Gs^Ftp, Dd^Ftd, Dd^Ftd, Ds, Ds, Wwf, Ds, Wwf, Wwf, Wwf, Wwt, Wo, Wo, Wot, Wot, Wot, Wwrt, Wwrt, Wwrt
Gs^Ft, Gs^Ft, Mm, Mm, Hh^Ft, Hh^Ft, Gs^Ft, Gs^Ft, Gs^Ftp, Hh^Ftp, Gs^Ftp, Ss, Ss, Gs^Ftp, Ss, Gs^Ftp, Wwf, Wwf, Wwt, Wwf, Wwt, Wwf, Wwt, Wwt, Wwt, Wwt, Wot, Wo, Wot, Wot, Wot, Wot, Wot, Wot
Hh^Ft, Hh^Ft, Hh^Ft, Hh^Ft, Gs^Ftp, Gs^Ft, Ss, Gs^Ftp, Ss, Gs^Ftp, Ww, Gs^Ftp, Ww, Ww, Ww, Ww, Wwt, Wwt, Wwt, Wwt, Wwt, Wwt, Wot, Wot, Wot, Wot, Wot, Wot, Wot, Wot, Wot, Wot, Wot, Wot
Hd^Ftd, Gs^Ft, Gs^Ft, Gs^Ft, Gs^Vdze, Gs^Ftp, Ss, Ww, Ww, Ww, Wwt, Ww, Wwt, Wwt, Wot, Wwt, Wot, Wwt, Wot, Wot, Wot, Wot, Wot, Wot, Wwt, Wot, Wo, Wot, Wo, Wot, Wwrt, Wot, Wot, Wot
