border_size=1
usage=map

Wot, Wot, Wot, Wot, Wwt, Wot, Wwt, Wot, Wot, Wot, Wot, Wot, Wot, Wot, Wot, Wot, Wot, Wot, Wwt, Wot, Wwt, Wot, Wot, Wot, Wot, Wot, Wot, Wot
Wot, Wot, Wwt, Wwt, Hd^Ft, Wwt, Hd^Ft, Wwt, Wot, Wot, Wot, Wot, Wot, Wot, Wwt, Wwt, Wwt, Wwt, Dd^Ft, Wwt, Hd^Ft, Wwt, Wwt, Wot, Wwt, Wot, Wot, Wot
Wot, Wwt, Hd^Ft, Hd^Ft, Md, Hd^Ft, Hd^Ft, Wwt, Wot, Wot, Wot, Chw, Wwrt, Wwt, Ss, Ss, Dd^Ft, Dd^Ft, Dd^Vhs, Dd^Ft, Md, Hd^Ft, Chw, Wwt, Wwt, Wot, Wot, Wot
Wot, Wwt, Hd^Ft, Md, Dd^Vdt, Gs^Ft, Ss, Wwt, Wwt, Wot, Wot, Wwrt, Wwrt, Wwt, Gs^Ft, Gs^Ft, Md, Hh^Ftp, Ds, Ds, Ww, Chw, 2 Khw, Chw, Ss, Wwt, Wot, Wot
Wot, Wwt, Wwt, Hd^Ft, Dd, Dd, Wwf, Wwf, Dd^Ft, Wwt, Wwt^Ft, Wwt, Wwt, Wwt, Wwt, Gs^Ft, Hh^Ftp, Dd^Ft, Wo, Wo, Wo, Chw, Chw, Chw, Dd^Ft, Wwt, Wot, Wot
Wot, Wot, Wwt, Wwt, Wwf, Wwt, Wwt, Dd^Ft, Dd, Dd^Ft, Dd^Ft, Wwf, Wwf^Ft, Wwf, Chw, Wwf^Ftd, Dd^Vhs, Dd, Wo, Wo, Wo, Ww, Dd, Gs^Ft, Dd^Ft, Wwt, Wot, Wot
Wot, Wot, Wwt, Wwf, Wwf, Wwt, Dd^Ft, Dd, Dd, Dd, Dd, Wwf^Ft, Wwf^Ft, Wwf, Wwf, Wwf, Wwf^Ft, Dd^Ft, Dd^Ft, Wwf^Ft, Dd^Ft, Dd, Dd^Vhs, Dd, Wwt, Wwt, Wot, Wot
Wo, Wwt, Dd, Wwf, Wwf, Wwt, Wwf, Chw, Dd, Dd^Vht, Dd^Ft, Dd^Ft, Ww, Wwf, Dd, Wwf, Ww, Ww^Ft, Ww, Ww, Ww, Wwf^Ft, Wwf, Wwf, Wwt, Wot, Wot, Wot
Wwt, Dd^Ft, Dd^Vdt, Dd, Wwf, Wwf, Wwf, Dd, Dd^Ft, Dd^Ft, Wwt, Wwt, Chw, Ww, Ww, Ww, Chw, Ww, Wo, Chw, Wo, Wwt, Wwf, Wwt, Wwt, Wot, Wot, Wot
Wwt, Dd^Ft, Dd, Dd, Dd^Ft, Wwf, Wwf, Wwf^Ft, Wwt^Ft, Wwt, Wot, Wot, Wot, Ww, Chw, Ww, Wo, Wo, Wot, Wo, Wwt, Wwt, Wwf, Wwt, Wot, Wot, Wot, Wot
Wwt, Wwt, Dd^Ft, Dd^Ft, Wwt, Wwt^Ft, Wwt^Ft, Wwf, Wwf, Wwt, Wwt^Ft, Wo, Wo, Wwf, Wo, Wo, Wot, Wot, Wwt, Wwt, Dd^Ft, Wwf^Ft, Dd^Ft, Wwt, Wwt, Wot, Wot, Wot
Wwt, Wwt, Wwt, Wwt, Wot, Wwt, Wwt^Ft, Wwf, Dd^Ft, Dd^Ft, Gs^Ft, Wwf^Ft, Wwf, Wwf, Wwt, Wot, Wot, Wot, Wwt, Dd^Ft, Hh^Ft, Hd^Ft, Hd^Ft, Wwf, Wwt, Wot, Wot, Wot
Wot, Wot, Wot, Wot, Wot, Wot, Dd, Dd^Ft, Dd^Vhs, Hh^Ft, Md, Gs^Ft, Ss, Wwf, Wwf^Ft, Wwt, Wwt, Wwt, Dd, Hd^Ft, Md, Md, Hh^Ft, Ds^Ft, Wwt, Wwt, Wot, Wot
Wot, Wot, Wot, Wot, Wot, Wot, Dd, Dd, Dd, Hh^Ft, Md, Gs^Ft, Dd, Dd^Ft, Dd^Ft, Wwf, Wwf, Wwf, Dd, Hh^Ft, Gs^Ft, Md, Hh^Ft, Dd, Dd^Ft, Wwt, Wot, Wot
Wot, Wot, Wot, Wot, Wot, Wot, Wot, Wwf, Wwf^Ft, Hd^Ft, Md, Md, Hh, Dd^Vhs, Dd^Ft, Wwf^Ft, Wwf, Wwf, Wwf, Dd, Dd, Gs^Ft, Dd, Dd^Vhs, Dd, Wwt, Wot, Wot
Wot, Wot, Wot, Wot, Wot, Wot, Wwt, Wwt, Wwf, Hd^Ft, Hh, Md, Hh^Ft, Dd^Ft, Wwt, Wwf, Wwt, Wwf, Wwt, Dd, Dd^Vhs, Dd, Dd^Ft, Dd^Ft, Wwt, Wwt, Wot, Wot
Wot, Wot, Wot, Wot, Wot, Wot, Wwt, Wwt, Dd, Dd^Ft, Hd^Ft, Hh, Hd^Ft, Dd^Ft, Wot, Wot, Wot, Wwt, Wwt, Wwt, Dd^Ft, Dd, Dd^Ft, Wwt, Wwt, Wwt, Wot, Wot
Wot, Wot, Wot, Wot, Wot, Wwt, Wwt, Wwt, Dd, Hd^Ft, Dd, Dd, Ds^Ft, Wwf^Ft, Wot, Wot, Wot, Wot, Wwrt, Wwt, Wwt, Wwt, Wwt, Wwt, Wwt, Wwt, Wot, Wot
Wot, Wot, Wot, Wot, Wwt, Wwt, Dd, Dd, Wwt, Dd, Wwf, Wwf, Wwf, Wwt, Wwrt, Wot, Wot, Wwrt, Wwrt, Wwt, Wot, Wwt, Wwt, Wwrt, Wwrt, Wot, Wot, Wot
Wot, Wot, Wot, Wot, Wot, Wwt, Wwt, Dd, Wwt, Wwt, Wwt, Wwf, Dd^Ft, Wwt, Wwt^Ft, Wot, Wot, Wwt, Wot, Wot, Wot, Wot, Wot, Wwrt, Wot, Wot, Wot, Wot
Wot, Wot, Wot, Wwt, Wwrt, Wwt, Wot, Wwt, Wot, Wot, Wwt, Dd^Ft, Dd^Ft, Wwf^Ft, Wwt^Ft, Wwt, Wot, Wot, Wot, Wot, Wot, Wot, Wot, Wot, Wot^Vm, Wot, Wot, Wot
Wot, Wot, Wwrt, Wwrt, Wwrt, Wwrt, Wwt, Wot, Wot, Wwt, Wwf^Ft, Wwf, Wwf, Wwf, Wwt^Ft, Wot, Wot, Wot, Wot, Wot, Wot, Wot, Wot, Wot, Wot, Wot, Wot, Wot
Wot, Wot, Wot, Wwt, Wot, Wot, Wwt, Wot, Wot, Wwt, Wwt, Wwf, Dd, Wwf^Ft, Dd^Ft, Wwt, Wwt, Wot, Wot, Wot, Wwt, Wot, Wwt, Wot, Wot, Wot, Wot, Wot
Wot, Wot, Wot, Wot, Wwt, Wwt^Vm, Wot, Wot, Wwt, Wwt, Dd^Ft, Dd, Hh^Ft, Hh^Ft, Dd^Vht, Dd^Ft, Wwt, Wot, Wot, Wwt, Dd^Ft, Wwt, Dd^Ft, Wwt, Wwt, Wot, Wot, Wot
Wot, Wot, Wot, Wot, Wot, Wwt, Wot, Wot, Wwt, Dd^Ft, Dd^Ft, Hh^Ft, Dd^Ft, Dd^Ft, Dd^Ft, Dd^Ft, Wwt, Wot, Wot, Wwt, Hd^Ft, Hd^Ft, Hh^Ft, Dd^Ft, Wwt, Wot, Wot, Wot
Wot, Wot, Wot, Wot, Wot, Wot, Wot, Wot, Wot, Wwt, Dd^Ft, Hh^Ft, Dd^Ft, Chw, Wot, Wwt, Wot, Wot, Wot, Wwt, Hd^Ft, Md, Hh^Ft, Dd^Ft, Wwt, Wot, Wot, Wot
Wot, Wot, Wot, Wot, Wot, Wot, Wot, Wot, Wot, Wot, Wot, Dd, Dd^Ft, Dd^Ft, Wot, Wot, Wot, Wot, Wot, Dd, Dd^Vdt, Hh^Ft, Dd^Ft, Dd^Ft, Wwt, Wot, Wot, Wot
Wot, Wot, Wot, Wot, Wot, Wot, Wot, Wot, Wwrt, Wot, Wot, Wot, Wot, Wot, Wot, Wot, Wot, Wot, Wot, Dd, Dd, Dd, Wwt, Wwt, Wot, Wot, Wot, Wot
Wot, Wot, Wot, Wot, Wot, Wot, Wot, Wot, Wwrt, Wwrt, Wot, Wot, Wot, Wot, Wot, Wot, Wot, Wot, Wot, Wot, Wot, Wot, Wot, Wot, Wot, Wot, Wot, Wot
Wot, Wot, Wot, Wot, Wot, Wot, Wot, Wwrt, Wwt, Wwrt, Wwrt, Wot, Wot, Wot, Wwrt, Wwt, Wwrt, Wot, Wot, Wot, Wot, Wot, Wot, Wot, Wot, Wot, Wot, Wot
Wot, Wot, Wot, Wot, 1 Wot, Wot, Wot, Wot, Wot, Wot, Wot, Wot, Wot, Wot, Wot, Wwrt, Wwrt, Wwt, Wot, Wot, Wot, Wot, Wot^Vm, Wot, Wot, Wot, Wot, Wot
Wot, Wot, Wot, Wot, Wot, Wot, Wot, Wot, Wot, Wot, Wot, Wot, Wot, Wot, Wot, Wwt, Wot, Wot, Wot, Wot, Wot, Wot, Wot, Wot, Wot, Wot, Wot, Wot
Wot, Wot, Wot, Wot, Wot, Wot, Wot, Wot, Wot, Wot, Wot, Wot, Wot, Wot, Wot, Wot, Wot, Wot, Wot, Wot, Wot, Wot, Wot, Wot, Wot, Wot, Wot, Wot
Wot, Wot, Wot, Wot, Wot, Wot, Wot, Wot, Wot, Wot, Wot, Wot, Wot, Wot, Wot, Wot, Wot, Wot, Wot, Wot, Wot, Wot, Wot, Wot, Wot, Wot, Wot, Wot
