border_size=1
usage=map

Wwt, Wwt, Wwt, Wwt, Wot, Wwt, Wot, Wot, Wot, Wot, Wot, Wot, Wot, Wot, Wot, Wot, Wwrt, Wot, Wot, Wwt, Wwt, Wwt, Wwt, Wwt, Wwt, Ww, Ww, Ww, Ww, Ww, Ww, Ww, Ww, Ww, Ww, Ww, Ww, Ww, Ww, Ww, Ww, Ww
Wwrt, Wwt, Wot, Wwt, Wot, Wot, Wwrt, Wwrt, Wot, Wot, Wwt, Wot, Wwt, Wot, Ww^Vm, Wot, Wot, Wwrt, Wwrt, Wot, Wot, Wwt, Wot, Wwt, Wwt^Vm, Wwt, Wwt, Wwt, Wwt, Wwt, Wwt, Wwt, Wwt, Ww, Wwt, Ww, Wwt, Ww, Wwt, Ww, Ww, Ww
Wwrt, Wwrt, Wot, Wot, 1 Wot, Wot, Wot, Wwrt, Wot, Wot, Wwt, Wwt, Ww, Wwt, Wwt, Wot, Wot, Wwrt, Wwrt, Wot, Wot, Wot, Wot, Wot, Wot, Wot, Wot, Wot, Wot, Wot, Wot, Wwt, Wot, Wwt, Wwt^Vm, Wwt, Wot, Wwt, Wwt, Wwt, Wwt, Ww
Wot, Wot, Wot, Wot, Wot, Wot, Wwt, Wot, Wwt, Wwt, Ww, Ww, Dd, Ww, Ww, Wwt, Wwt, Wot, Wot, Wot, Wot, Wot, Wot, Wot, Wot, Wot, Wot, Wot, Wot, Wot, Wot, Wot, Wot, Wot, Wot, Wot, Wot, Wot, Wot, Wot, Wot, Wwt
Wot, Wot, Wot, Wot, Wot, Wwt, Wwt, Wwt, Wwt, Ww, Dd, Dd, Dd, Chw, Ww, Wwt, Wwt, Wot, Wwt, Wot, Wot, Wwrt, Wwrt, Wot, Wot, Wot, Wwt, Wwt, Wwt, Wwt, Wwt, Wot, Wwt, Wot, Wwt, Wot, Wwt, Wot, Wwt, Wot, Wot, Wot
Wwt, Wwt, Wwt, Wwt, Wwt, Wwt, Ww, Wwt, Ww, Ww, Dd, Dd, Dd, Chw, Dd, Ww, Ww, Wwt, Wwt, Wwt, Wot, Wot, Wot, Wot, Wwt, Wwt, Wwt, Wwt, Wwt, Wwt, Wwt, Wwt, Ww, Wwt, Ww, Wwt, Ww, Wwt, Wwt, Wwt, Wwt, Wwt
Wwt, Wwt, Wwt, Wwt, Dd, Ww, Dd, Ww, Dd, Dd, Dd^Vhs, Dd, Dd, Dd, Chw, Chw, Dd, Ww, Ww, Wwt, Wwt, Wot, Wot, Wot, Wwt, Dd, Ww, Ww, Dd, Ww, Dd, Ww, Dd, Ww, Dd, Ww, Dd, Ww, Ww, Ww, Ww, Ww
Dd, Dd, Dd, Dd, Dd^Vht, Dd, Dd^Dr, Dd, Dd, Dd, Dd, Dd, Dd, Dd, Dd, Dd, Dd^Dc, Dd, Ww, Wwt, Wwt, Wot, Wot, Wwt, Ww, Ww, Dd, Dd, Dd^Vht, Dd, Dd, Dd, Dd^Ftd, Dd, Dd, Dd, Dd, Dd, Dd, Ww, Dd, Ww
Dd, Dd, Dd, Dd, Dd, Dd, Dd, Dd, Dd^Ftd, Dd^Ftd, Gs^Ft, Dd^Ftd, Dd^Ftd, Dd, Dd, Dd, Dd, Dd, Dd, Ww, Ww, Wwt, Wwt, Wot, Wo, Ww, Ww, Dd, Dd, Dd, Dd^Ftd, Dd^Ftd, Gs, Gs^Ftd, Gs, Dd^Ftd, Gs^Ftd, Dd^Ftd, Dd^Ftd, Dd, Dd, Dd
Ds, Dd, Dd^Ftd, Dd^Ftd, Dd^Ftd, Dd, Dd^Ftd, Dd^Ftd, Gd, Gd, Gll, Gd, Gd, Gs^Ft, Gs^Ft, Dd, Dd, Dd^Vhs, Dd, Ww, Ww, Ww, Wwt, Wot, Ww, Ww, Ww^Bw/r, Dd, Dd, Dd, Dd^Ftd, Gs, Gll, Gll, Gll, Gs, Gll, Gs, Gll, Dd^Ftd, Ds^Ftd, Dd
Ds, Dd^Ftd, Gs, Gs, Gg, Gs^Ft, Gs^Ft, Gs^Ft, Gll, Gll^Fdf, Gll^Fdf, Gll^Fdf, Gll, Gs, Gs, Gs^Ft, Dd^Ftd, Dd, Dd^Dc, Dd, Dd, Ww, Ww, Wwt, Wo^Bw/r, Ww^Bw/r, Ww, Ww, Dd, Dd, Gs, Gs, Gll, Hhd^Fdf, Hhd^Fdf, Gll, Gll, Hhd^Fdf, Gs, Gs, Gs^Ft, Gs^Ft
Gs, Dd^Ftd, Gg, Gs^Ft, Gs^Ft, Gg, Gs, Gll, Gll^Fdf, Gll^Fdf, Gll^Fdf, Gll^Fdf, Gll, Ss, Ss, Gs, Gs^Ft, Dd, Dd, Dd, Dd, Wwf, Ww^Bw/r, Wo^Bw/r, Wo, Ww, Wo, Ww, Ww, Dd, Dd^Ftd, Gs, Gll, Hhd^Fdf, Gll, Gll, Gs, Gs, Hh^Fmw, Gs, Gs, Gs^Ft
Gg, Gg, Gg, Gg, Gg, Gg, Ss, Gll, Gll, Gll, Gll, Gll, Ss, Ss, Gs, Gs, Gs, Dd^Ftd, Ce, Dd, Dd, Dd, Wwf, Wwr, Wo, Wo, Wo, Ww, Ww, Dd, Gs, Gs, Gs, Gll, Gs, Hh^Fmw, Hh^Fdw, Hh, Mm, Hh^Fdw, Hh^Vht, Gs
Ss, Ss, Gs, Ss, Ss, Ss, Ss, Gs, Gs, Gs, Gs, Ss, Ss^Vm, Gs, Gs, Gs^Ft, Gs^Ft, Ce, 4 Ke, Ce, Dd, Dd, Wwf, Wwr, Wo, Wot, Wo, Wo, Ww, Ss, Ss, Gs, Gs^Vht, Gs, Hh^Fmw, Hh^Fdw, Mm, Mm, Hh^Ftp, Hh^Ftp, Hh^Ftp, Hh^Ftp
Ss, Gs, Ss, Ss^Vhs, Gs, Ss, Ss, Ss, Gs, Gs, Ss, Ss, Ss, Ss, Ss, Ss, Gs^Ft, Ce, Ce, Ce, Dd, Dd, Dd, Ww, Ww, Wo, Wo, Ww, Ww, Ss, Ss, Gs, Gs, Gs, Gs, Hh^Fdw, Hh^Fdw, Mm, Hh^Ftp, Mm, Hh^Ftp, Hh^Ftp
Ss, Gs, Ss, Ss, Gs, Gs, Gs, Ss, Gs, Ss, Ss, Ss, Ss, Gs, Gs, Gs, Gs, Gs, Dd^Ftd, Dd^Ftd, Dd, Dd, Dd, Ww, Ww, Wo, Wo, Wo, Ww, Ww, Ss, Gs, Gs, Gs, Ce, Hh^Fdw, Hh^Fdw, Mm, Mm, Mm, Hh^Ftp, Hh^Ftp
Gg, Ss, Ss, Ss, Ss, Ss, Gs, Ss, Ss, Gs, Ss, Ss, Gs, Gs, Ss, Gs, Ss, Gs, Gs^Ft, Dd^Ftd, Dd, Dd^Dc, Dd, Dd, Ww, Wwr, Wo, Wo, Wo, Ww, Ss, Ss, Gs, Ce, 3 Ke, Ce, Hh^Fdw, Hh^Fdw, Mm, Mm, Mm, Hh^Ftp
Ss, Ss, Ss, Ss, Chs, Ss, Ss, Ss, Ss^Vhs, Ss, Ss, Ss, Ss, Ss, Ss, Ss^Vm, Gs, Gs, Gs^Ft, Dd^Ftd, Dd, Dd, Dd, Dd, Ww, Wwr, Wo, Wot, Wo, Ww, Ww, Ss, Ss, Ce, Ce, Ce, Gs, Hh^Fdw, Mm, Mm, Hh^Ftp, Mm
Gs, Gs, Gs, Chs, 2 Khs, Chs, Ss, Ss, Ss, Ss, Gs, Ss, Gs, Ss, Gs, Ss, Gs, Gs, Gs, Dd^Ftd, Dd^Ftd, Dd, Dd^Vhs, Dd, Dd, Ww, Ww, Wo, Wo, Ww^Vm, Ww, Ww, Ww, Ss, Ss, Gs, Gs, Hh^Fdw, Hh^Fdw, Mm, Hh^Ftp, Mm
Ss, Ss, Ss, Chs, Chs, Chs, Gs, Ss, Ss, Ss, Ss, Gs, Gs, Gs, Gs, Gs, Gs, Gs, Gs, Gs^Ft, Dd^Ftd, Dd, Dd, Dd, Dd, Ww, Ww, Ww, Wo, Wo, Wo, Ww, Ww, Ss, Ss, Gs, Gs, Gs, Hh^Fdw, Mm, Mm, Mm
Ss, Ss, Ss, Ss, Ss, Ss, Gs, Gs, Ss, Ss, Ss, Ss, Ss, Ss, Ss, Ss, Ss, Gs, Ss, Gs, Gs, Dd^Ftd, Dd, Dd, Dd^Dc, Dd, Wwf, Ww, Ww, Wo, Wo, Ww, Ww, Ss, Ww, Ss, Gs, Gs^Vhs, Hh, Mm, Mv, Mm^Xm
Gs, Ss, Gs, Gs, Gs, Gs, Gs, Ss, Gs, Ss, Ss, Ss, Ss^Vm, Ss, Ss, Ss, Chs, Ss, Chs, Ss, Ss, Gs^Ft, Dd^Ftd, Dd, Dd, Dd, Dd, Wwf, Wwf, Ww, Ww, Wo, Ww, Ww, Ww, Ss, Ss, Gs, Hh, Mm, Mm, Mm
Gg, Gg, Gg, Gs, Ss^Vhs, Gs, Gg, Gg, Gs, Gs, Gs, Gs, Gs, Gs, Gs, Ss, Ss, 5 Khs, Chs, Ss, Gs, Gs^Ft, Gs^Ft, Dd, Dd, Dd, Dd^Vht, Dd, Dd, Wwr, Wwr, Ww, Wo, Ww, Ww, Ww, Ww, Gs, Gs, Hh, Mm, Mm^Xm
Ss, Gg, Ss, Ss, Ss, Ss, Ss, Gg, Ss, Gs, Ss, Ss, Gs, Ss, Ss, Ss, Ss, Ss, Ss, Ss, Gs, Gs, Ss, Gs^Ft, Gs^Ft, Dd, Dd^Ftd, Dd, Dd, Ss, Wwr, Ww, Ww, Ww, Ww, Ss, Ss, Ww, Ss, Gs, Mm, Mm^Xm
Ss, Ss, Ss, Ss, Ss, Ss, Gg, Ss, Ss, Ss, Gg, Ss, Ss, Ss, Gg, Ss, Gg, Ss, Gg, Gs, Gs, Ss, Ss, Ss, Ss, Ss, Ss, Dd^Ftd, Dd^Ftd, Dd, Ss, Wwr, Wwr, Wwr, Ww, Ss, Ss, Ww, Ww, Ss, Mm, Mm
