border_size=1
usage=map

Gll, Gs^Fmf, Gs^Fmf, Hh^Fp, Gs^Fmf, Gs^Fmf, Gll, Gll, Gll, Gll, Gd, Gll, Gs^Fdw, Hh^Fdw, Ha^Fma, Ha^Fma, Ha^Fpa, Ha^Fpa, Ms, Ms, Ms, Ms, Ms, Ha, Ha^Fma, Ms, Ms, Ms, Ms, Ms, Ms, Ms, Ms, Ms
Gll, Gll, Gs^Fmf, Gs^Fmf, Gll, Gll, Gll, Gll, Ce, Gll, Gll, Gll, Gd, Hh^Fdw, Hh^Fdw, Ha^Fma, Ha^Fpa, Ms, Ha^Fpa, Ms, Ha^Fma, Ms, Ms, Ms, Ms, Ha^Fma, Ms, Ms, Ms, Ms, Ms, Ms, Ms, Ms
Gd, Gd, Gll, Gs^Fmf, Gs^Fmf, Gs^Fmf, Gs^Fmf, Ce, 3 Ke, Ce, Hhd^Fdw, Gd, Gd^Vo, Gd, Gd, Ha^Fma, Ha^Fma, Ms, Ha^Fda, Ha^Fma, Ha^Fda, Ha^Fma, Ha^Fma, Ha, Ha, Ms, Ms, Ms, Ha, Ms, Ms, Ms, Ms, Ms
Gd, Gd, Gs^Fmf, Gs^Fmf, Gg^Ve, Gs^Fmf, Gs^Fmf, Ce, Ce, Ce, Hhd^Fdw, Gll, Hhd, Gll, Hhd^Fmf, Gs^Fmf, Ha^Fma, Ms, Ha^Fda, Gs, Gs^Vc, Gs^Fmw, Ww, Ai, Ai, Ms, Ms, Ha, Rp, Ha, Ms, Ms, Ms, Ms
Gd, Gd, Gll, Gs^Fms, Gs^Fmf, Gs^Fmf, Gs^Fmf, Gs^Fmf, Hh^Fmf, Aa^Fma, Aa^Fma, Gll, Gll, Gll, Gs^Fdw, Gs^Fmf, Ha^Fma, Ha^Fda, Gs^Fmw, Gs^Fmw, Hh, Gs^Fmw, Ww, Ai, Aa, Ha^Fma, Ms, Ha, Rp, Ha, Ms, Ha^Vca, Ms, Ms
Gs^Fmf, Gd, Gd, Gs^Fmf, Gs^Fdw, Gs^Fmf, Gs^Fmf, Aa^Fma, Ha^Fma, Ha^Fma, Gs^Fmf, Gs^Fdw, Gd, Aa, Gs, Hh^Fmf, Hh^Fmf, Ww, Ww, Gs^Fmw, Gs^Fmw, Gs^Fmw, Ww, Ww, Hh^Es, Hh^Fmf, Hh^Fmf, Ms, Ha^Fma, Rp, Ha, Ms, Ms, Ms
Gs^Fmf, Gd, Aa, Gs, Gs^Fdw, Gs^Fdw, Gs^Fmf, Ha^Fma, Ha^Fma, Ha^Fma, Gs^Fmf, Gs^Fmf, Gll, Aa, Gs, Gs^Fdw, Gs^Fmf, Gs^Fmf, Gd, Ww, Ww, Ww, Hhd^Fmf, Hhd^Fmf, Gll, Hh^Es, Ai, Ha^Fma, Ha^Fma, Rp, Ms, Ms, Ms, Ms
Gd, Gd, Aa, Gs, Gll, Gs^Fmf, Gll, Gll, Gll, Gll, Hhd^Fmf, Gs^Fmf, Gs^Fms, Gs, Ss, Gd, Gll, Ce, Gs, Ww, Ha^Fma, Hh^Fmf, Hh^Es, Gll, Gs^Vc, Gs, Ww, Hh^Fdw, Hh, Rp, Ch, Ms, Ms, Ms
Gs, Gs, Gg^Vo, Gs, Gs, Gll, Gs^Fmf, Gs^Fmf, Gll^Fmf, Hhd^Fmf, Gll, Gs^Fmw, Gs, Gs, Ww, Ww, Ww, Gs, Ww, Ww, Hh^Fmf, Ha^Fma, Hh^Es, Gll, Gd, Gs, Ss, Ww, Hh, Ch, 2 Ke, Cea, Ms, Ms
Gd, Gs, Gs, Gs, Aa, Aa, Gs, Gll, Gs^Fdw, Gs^Fmf, Ce, Ce, Gs, Gs, Ww, Gs, Gs^Vc, Ww, Ss, Gs^Fmf, Gs^Fmf, Hh^Es, Gs, Gd, Hh^Es, Rr, Rr, Ai^Bw/, Hh, Ce, Cea, Cea, Ms, Ms
Gs^Fmf, Gd, Gd, Gs, Aa, Aa^Fpa, Aa, Gs, Gs, Gs, Ce, Ke, Gs, Ww, Gs^Fms, Gs, Gll, Gll, Gd, Ss, Ss, Gll, Gll, Gd, Hh^Es, Hh^Es, Ww, Ai, Ss, Hh^Fdw, Ms, Ms, Ms, Ms
Gs^Fmf, Gs^Fmf, Gd, Aa, Aa, Aa^Fpa, Gs, Gs, Gd, Gs, Gll, Gs, Ww, Ww^Bw\, Gs, Gs, Gll, Hhd^Fmf, Hhd^Fmf, Gd, Gll, Gll, Hhd^Fmf, Ce, Ss, Hh^Es, Ww, Ww, Ai, Hh^Fdw, Ms, Ms, Ms, Ms
Gd, Gd, Gll, Gd, Gd, Gs, Gd, Gd, Gd, Gll, Gs^Fmf, Gs^Fmf, Ww, Gs, Gs, Gd, Gll, Hhd^Fmf, Gll, Gll, Gll, Gll^Fmf, Hhd^Fmf, Ss, Ww, Ww, Gs^Vc, Ww, Gs^Fdw, Hh^Fmf, Ha^Fma, Ms, Ms, Ms
Gd, Gll, Gs^Fmf, Gs^Fmf, Gs^Fmw, Gs, Gs, Gd, Gs, Gs, Ss, Ww, Gs^Fmf, Gs, Ce, Gd, Gd, Gll, Aa, Aa, Gll, Hhd^Fmf, Ss, Ss, Ss, Ww, Gd, Ww, Ww, Hh^Fmf, Ms, Ms, Ms, Ms
Gd, Gs^Fmf, Gs^Fmf, Gs^Fmf, Gd, Gd, Gs, Gs, Gs, Gs, Ss, Ww, Ss, Gs^Fmf, Ce, Ke, Gs, Gs, Aa^Fpa, Aa^Fpa, Gs, Gll, Ss, Ha^Fma, Ha^Fma, Gs^Fmf, Gs^Fmf, Gs^Fmf, Gs^Fmf, Hh^Fmf, Ms, Ms, Ms, Ms
Gd, Gll, Gll, Gll, Aa, Gs, Gs, Gs, Ss, Ss, Ss, Ss, Ss, Ss, Gs, Ce, Gs, Ss, Ss, Aa^Fpa, Ss, Ss^Bw|, Ss, Gs^Fmf, Aa, Gs^Fmf, Ha^Fpa, Hh^Fmf, Ha^Fma, Ha^Fma, Ha^Fma, Ms, Ms, Ms
Gd, Gd, Gs, Gs, Aa^Fpa, Aa^Fpa, Aa, Gs, Gs, Gs, Gd, Gs, Gd, Ss, Ss, Gs, Ss, Ss, Ww, Ss, Ww, Ww^Bw|, Gll, Gll, Gs^Vc, Aa, Ha^Fpa, Ms, Ha^Fma, Ms, Ha^Fma, Ms, Ms, Ms
Gd, Gd, Gs, Gs, Aa, Aa^Fpa, Gs, Gs, Gs, Gll, Gs^Fmf, Gll, Gs^Fmf, Gs^Fms, Ss, Ss, Ss, Ww, Ss, Ww, Gll, Gll, Gs^Fmf, Gll, Gd, Aa, Aa^Fda, Ha^Fma, Aa^Fda, Ha^Fma, Ha^Fma, Ha^Fma, Ha^Fma, Ms
Gd, Gd, Gd, Gd, Gs, Gs, Gs, Gd, Gs, Gll, Gs^Fmf, Gs^Fmf, Ww, Gs^Fms, Ww, Ww, Ss, Ss, Gll, Gll, Gs^Fmf, Gs^Fmf, Ha^Fma, Hh^Fmf, Ha^Fpa, Ha^Fpa, Ha^Fma, Aa^Fma, Aa^Fma, Aa^Fda, Aa^Fda, Ha^Vca, Aa^Fma, Ha^Fma
Gd, 1 Gd, Gs, Gs, Gs, Gs, Gd, Gs^Vc, Gs, Gll, Gll, Gll, Gs, Ww, Gs, Gs, Gll, Gd, Gs^Fmf, Gs^Fmf, Gs^Fmf, Ha^Fma, Ms, Ms, Ms, Ms, Ms, Aa^Fma, Aa^Fma, Aa^Fma, Aa^Fda, Aa^Fda, Aa^Fma, Aa^Fma
Gd, Gd, Gd, Gd, Gs^Fmw, Gd, Gs, Gd, Gs, Gll, Ss, Gs, Ww, Ww^Bw\, Gs, Gs^Vc, Gs, Gd, Gd, Gll, Gd, Ha^Fma, Ha^Fma, Ha^Fma, Ha^Fma, Ha^Fma, Ha^Fma, Aa^Fma, Gs, Aa^Fda, Aa, Aa, Gs, Aa^Fma
Gd, Gd, Gd, Gs^Fmw, Gs^Fmw, Gs^Fmw, Gs, Gs, Gs, Ss, Ss, Ww, Gs, Gs, Gs, Gs, Aa, Aa, Aa, Aa, Aa, Gs, Gs, Aa^Fpa, Gs, Aa^Fpa, Gs, Gs, Gs, Gs, Aa, Aa^Fpa, Gs, Gs
