border_size=1
usage=map

Dd, Aa, Aa, Aa, Aa, Aa, Aa, Aa, Aa, Aa, Aa, Aa, Aa, Aa, Aa, Aa, Aa, Dd, Dd, Dd, Aa, Aa, Aa, Aa, Aa, Aa, Aa, Ha, Ha^Fma, Ha^Fma, Ms, Ms, Ms, Ms, Ha^Fma
Dd, Dd, Dd, Aa, Co, Aa, Aa, Aa, Rp, Aa, Rp, Aa, Rp, Aa, Co, Aa, Aa, Aa, Dd, Dd, Aa, Aa, Aa, Aa, Dd, Dd, Aa, Aa, Ha^Voa, Ha^Fma, Ha^Fma, Ms, Ms, Ha^Fma, Ha^Fma
Aa, Dd^Vdt, Dd, Aa, Rp, Rp, Rp, Aa, Rp, Rp, Rp, Rp, Rp, Rp, Rp, Rp, Aa, Dd^Vdt, Dd, Dd, Dd, Aa, Aa, Aa, Dd, Dd, Dd, Aa, Aa, Ha, Ha^Fma, Ms, Ha^Fpa, Ha^Fpa, Ai
Aa, Dd, Rp, Aa, Rp, Rp, Aa, Rp, Rp, Rp, Rp, Aa, Aa, Rp, Rp, Aa, Rp, Aa, Rp, Rp, Rp, Rp, Aa, Dd, Aa, Rp, Rp, Rp, Aa, Aa, Ha^Fma, Ha^Fpa, Ww, Ww, Ai
Rp, Rp, Rp, Rp, Co, Rp, Aa, Rp, Co, Co, Co, Rp, Rp, Rp, Co, Rp, Rp, Aa, Rp, Rp, Chw, Aa, Rp, Aa, Aa, Aa, Ch, Rp, Aa, Aa, Ha^Fpa, Ha^Fpa, Ww, Ha^Fpa, Ha^Fpa
Aa, Rp, Rp, Rp, Rp, Rp, Rp, Rp, Co, 3 Ko, Co, Rp, Rp, Rp, Rp, Rp, Aa, Rp, Ai, Ai, Dd, Ww, Ww, Rp, Gs^Fdw, Aa, Aa, Aa, Aa, Ha^Fpa, Ww, Ww, Ha^Fpa, Ha^Fpa, Ms
Aa, Co, Aa, Aa, Rp, Rp, Rp, Rp, Rp, Co, Rp, Rp, Rp, Aa, Aa, Aa, Aa^Voa, Aa, Wwf, Dd, Dd, Dd, Wwf, Gs^Fmw, Ce, Ce, Ce, Rd, Rd, Ha^Fpa, Ww, Ha^Fpa, Ha^Vhha, Ms, Ms
Gs, Aa, Gs, Aa, Co, Rp, Rp, Rp, Rp, Rp, Rp, Rp, Rp, Rp, Co, Gs, Gs, Gs, Ww, Dd, Dd, Dd, Ww, Gs^Fmw, Ce, 4 Ke, Ce, Ha^Fda, Ai, Ww^Bw\, Ss^Bw\, Ha^Fpa, Ha^Fma, Ms, Ms
Gs, Gs, Gg^Vo, Gs, Gs, Aa, Aa, Rp, Aa, Rp, Rp, Rp, Aa, Aa, Gs, Gs, Ww, Ww, Aa, Ww, Ww, Ww, Ai, Gs^Fmw, Ss, Ce, Aa^Fma, Ha^Fpa, Ww, Ww, Ss, Rd, Rd, Ha^Fma, Aa^Fda
Gs, Gs, Gs, Gs, Aa^Fpa, Aa, Gs, Co, Aa, Aa, Aa, Co, Gs, Aa, Aa, Aa, Ww, Aa, Ai, Ai, Ww, Ai, Ww, Ss, Ww, Ss, Ss, Ww, Ss, Ss, Ss, Ss, Rd, Ha^Fda, Aa^Fda
Aa, Aa^Fma, Aa, Aa^Fpa, Aa^Fpa, Gs, Gs, Gs, Gs, Aa, Gs, Gs, Gs, Ai, Ww, Ww, Ai, Ai, Aa^Voa, Ai, Ai, Ww, Ai, Ww, Ss, Ww, Ww, Ww, Ss, Ss^Vhs, Gs, Aa^Fma, Rd, Gs, Aa
Aa^Fma, Aa^Fma, Aa, Aa, Gs^Fmw, Aa^Fpa, Aa, Gs, Aa, Gs, Gs, Gs, Ww^Bw\, Ww, Ss, Aa, Aa, Aa, Aa^Fma, Aa, Aa, Ai, Aa, Ai, Gs^Fmw, Gs^Fmw, Aa^Fma, Ai, Gs, Gs, Gs, Aa, Gs, Rd, Rd
Aa^Fma, Aa, Aa, Gs^Fmw, Gs^Fmw, Aa, Aa^Fpa, Aa, Aa^Fpa, Aa^Voa, Aa^Fpa, Gs, Ww, Rd, Rd, Ss, Gs, Aa^Fma, Gs, Aa^Fma, Gs, Aa, Gs, Aa^Fma, Aa^Fma, Gs^Fmw, Aa^Fda, Aa^Fma, Gs, Gd, Gd, Gs, Gs, Gs, Rd
Aa^Fpa, Aa^Fma, Aa^Voa, Aa, Aa^Fpa, Aa^Fma, Ai, Aa^Fpa, Ww, Aa, Ww, Ww, Gs, Gs, Rd, Rd, Rd, Gs, Rd, Gs, Gs, Gs, Gs, Aa^Voa, Gs, Aa^Fma, Aa, Aa^Fma, Aa^Fda, Gs, Gs, Gs, Aa, Aa, Aa
Aa^Fda, Aa^Fma, Gs^Fmw, Aa^Fda, Ai, Ai, Aa^Fpa, Ww, Aa, Ww, Aa^Fma, Aa^Fma, Gs, Gs, Rd, Co, Gs, Rd, Gs, Rd, Rd, Rd, Rd, Gs, Rd, Gs, Gs, Gs, Gs, Gs, Gd, Aa^Fma, Aa^Voa, Aa, Gd
Aa^Fma, Aa^Fma, Ww, Ww, Gs^Fmw, Aa^Fma, Gs^Fmw, Aa^Fpa, Gs, Aa, Gs, Aa^Fma, Gs, Rd, Gs, Gs, Aa^Fpa, Gs, Aa, Gs, Gd, Gd, Gs, Rd, Gs, Rd, Rd, Rd, Rd, Gd, Rd, Gd, Gd, Gd, Gd
Aa^Fma, Aa^Fma, Ai, Ww, Aa, Aa^Fma, Gs^Fdw, Gs^Fdw, Gs, Gs, Gs^Vo, Gs, Rd, Rd, Gs, Gs, Gs, Aa, Aa^Fma, Gs, Gs, Gs, Gs^Fdw, Gs, Gs^Fdw, Gs, Gs, Gs, Gs, Rd, Gd, Rd, Rd, Rd, Rd
Aa, Ai, Aa, Aa, Gs, Gs, Gs, Gs, Gs, Gs, Gs, Gs, Rd, Gs, Aa, Gs, Gs^Fdw, Gs, Gs, Aa, Gs, Gs, Aa, Gs^Fdw, Aa, Gs^Fmw, Aa, Ss, Ss, Gs, Gs, Gd, Gd, Gd, Gd
Ai, Ai, Aa, Gs, Gs^Vc, Gs, Aa^Fma, Aa^Fma, Aa, Aa, Gs, Rd, Gs, Gs, Aa, Gs, Gs, Gs^Fdw, Gs, Aa, Aa, Gs, Gs, Aa, Aa^Voa, Aa, Ai, Ss, Gs, Gs, Gs, Aa^Fma, Aa, Gd, Gd
Aa^Fda, Aa, Gs, Gs, Gd, Gs, Aa, Ha^Fpa, Aa, Gs, Rd, Rd, Gs, Gs, Aa^Fma, Aa, Gs, Gs, Gs, Aa, Gs, Gs, Gs, Aa, Aa, Aa, Gs, Ss, Gs, Gs, Gs, Gs, Gs, Gs, Gs
Aa^Fda, Aa^Fda, Gs, Gd, Gs, Gs, Gs, Aa, Gs, Gs, Rd, Gs, Gs, Aa, Aa, Gs, Gs, Gs^Vo, Gs, Gs, Gs, Gs, Gs, Gs, Gs, Gs, Gd, Gs, Ce, Ce, Ce, Gs, Gs, Gs^Vht, Gs
Aa^Fda, Gs, Aa, Gs, Ce, Ce, Ce, Gs, Gs, Rd, Gs, Gs, Gs^Fdw, Gs, Gs, Gs, Gs, Gs, Aa, Gs, Gs, Gs^Fdw, Gs^Fdw, Gs^Fdw, Gs, Gd, Gd, Gs, Ce, 1 Ke, Ce, Gs, Gd, Gd, Gd
Aa^Fda, Aa, Gs, Gs, Ce, 2 Ke, Ce, Gs, Rd, Rd, Gs, Gs^Fdw, Gs^Fdw, Gs, Aa, Aa, Gs, Gs, Aa, Aa, Gs, Gs^Fdw, Gs^Fdw, Gs, Gs, Gd, Gs, Gs, Gs, Ce, Gs, Gs, Gs, Gd, Gs
Aa^Fda, Gs, Gs^Fdw, Gs, Gs, Ce, Gs, Gs, Rd, Gs, Gs, Gs, Gs, Gs, Aa^Fma, Aa^Fma, Aa^Fma, Aa, Aa^Fma, Aa^Fma, Gs, Gs, Gs, Gs, Gs, Gs, Aa, Gs, Aa, Gs, Aa, Aa, Aa, Gs, Aa
Gs, Gs, Gs^Fdw, Gs^Fdw, Gs, Gs, Gs, Rd, Gs, Gs, Gs^Vc, Gs, Aa, Aa, Aa, Aa^Fma, Gs, Aa^Fma, Aa, Gs, Gd, Gd, Gs, Gs, Gs, Gs, Aa, Aa, Aa^Fma, Aa, Ha^Fda, Aa, Aa^Fda, Aa, Aa
Gs, Gs^Fdw, Gs^Fdw, Gs, Aa^Fma, Gs, Rd, Rd, Gs, Gs, Gs, Gs, Gs, Aa, Gs, Gs, Gs, Gs, Gs, Gs, Gd, Gd, Gs, Gs^Vht, Gs, Aa, Aa, Aa^Fma, Ha^Fda, Aa^Fda, Ha^Fma, Ha^Fma, Aa^Fma, Aa^Fda, Aa^Fda
Gg, Gs^Fdw, Gs, Gs, Aa^Fma, Gs, Rd, Gs, Aa, Aa, Aa, Gs, Gs, Gs, Gs, Gs, Aa, Gs, Gs, Gs, Gd, Gs, Gs, Gs, Aa, Aa, Aa, Ha^Fpa, Ha^Fpa, Ha^Fpa, Ha^Fpa, Ha^Fpa, Ha^Fpa, Aa^Fma, Aa^Fda
