border_size=1
usage=map

Aa, Ai, Dd^Es, Dd^Es, Wwt, Wwt, Wot, Wot, Wot, Wot, Wot, Wot, Wot, Wot, Wot, Wot, Wot, Wot, Wot, Wot, Wot, Wot, Wot, Wot, Wot, Wot, Wot, Wot, Wot, Wo, Wo, Wo, Wo, Wo, Ww, Ww, Ww, Ww
Aa, Ai, Wwt, Wwt, Wot, Wot, Wot, Wot, Wot, Wot, Wot, Wot, Wwt, Wot, Wwt, Wot, Wot, Wot, Wot^Vm, Wot, Wot, Wot, Wot, Wot, Wot, Wot, Wot, Wot, Wo, Wo, Ww, Wo, Ww, Ww, Ww, Ww, Ww, Ww
Dd, Dd, Wwt, Wot, Wot, Wot, Wot, Wot, Wot, Wot, Wot, Wwt, Wwrt, Wwt, Wwrt, Wwt, Wwt, Wot, Wot, Wot, Wot, Wot, Wot, Wot, Wot, Wot, Wo, Wo, Ww, Ww, Ww, Ww, Ww, Ww, Dd^Es, Dd, Dd, Dd
Wwt, Wwt, Wot, Wot, Wot, Wot, Wot^Vm, Wot, Wot, Wot, Wwt, Wwt, Wwt, Wwt, Wwt, Wwrt, Wwt, Wot, Wot, Wot, Wot, Wot, Wo, Wot, Wo, Wo, Ww, Ww, Ww, Ww, Dd^Ftd, Ww, Dd, Dd, Dd^Es, Hd, Hd, Hd
Wwt, Wot, Wot, Wot, Wot, Wot, Wot, Wot, Wot, Wot, Wwt, Ww^Vm, Wwt, Ww^Vm, Wwt, Wwt, Wot, Wot, Wot, Wot, Wo, Wo, Wo, Wo, Ww, Ww, Ww, Ww, Gs^Ft, Dd^Ftd, Dd, 1 Dd, Dd, Dd^Vdt, Dd^Ftd, Dd^Ftd, Hd, Hd
Wot, Wot, Wot, Wot, Wwt, Wwt, Ww^Vm, Wwt, Wwt, Wwt, Wwt^Fet, Wwt, Chw, Wwt, Wwrt, Wot, Wot, Wot, Wo, Wo, Ww, Ww, Ww, Ww, Ww, Ww, Dd^Ftd, Gs^Ft, Dd^Es, Dd, Dd^Es, Dd, Dd^Es, Dd^Es, Dd, Hd, Hh^Ft, Hh^Ft
Wot, Wot, Wot, Wwt, Dd^Ftd, Wwt, Wwt, Wwt, Wwt^Fet, Wwt^Fet, Chw, 2 Khw, Wwt^Fet, Chw, Wot, Wot, Wot, Wo, Wo, Ww, Ww, Ww, Ww, Ww, Ww, Ww, Ss, Dd^Es, Dd^Es, Dd^Es, Gs^Ft, Gs^Ft, Ss, Gs^Ft, Gs^Ft, Gs^Ft, Gs^Ft, Gs^Ft
Wot, Wot, Wot, Wwt, Wwt, Wwt, Wwt, Dd^Ftd, Wwt, Chw, Wwt^Fet, Wwt^Fet, Wot, Wot, Wot, Wot, Wo, Wo, Ww, Ww, Ww, Ww, Dd^Ftd, Dd^Ftd, Dd^Es, Ds^Fet, Gs^Ft, Ss, Dd^Es, Gs^Ft, Ss, Ss, Ss, Gs^Ft, Ss, Ss, Ss, Ss
Wot, Wot, Wwt, Wwt, Wwrt, Wwrt, Wwt, Dd^Ftd, Wwt, Chw, Wot, Wot, Ww^Vm, Wot, Wo, Wo, Wo, Ww, Ww, Ww, Ss, Dd^Ftd, Gs^Ft, Dd^Es, Dd^Vdt, Dd^Es, Ss, Ss, Ss, Ss, Ss, Ss^Vm, Ss, Ss, Ww, Ww, Ww, Ww
Wot, Wot, Wwt, Wwt, Wwrt, Wwt, Wwt, Wwt, Wot, Wot, Wot, Wot, Wot, Wot, Wo, Wo, Wwr, Ww, Ww, Ss, Ss, Gs^Ft, Ww^Fet, Dd^Es, Dd^Es, Dd, Ss, Ss, Ss, Dd^Es, Ss, Dd^Es, Ss, Ss, Ww, Ss, Ss, Ss
Wwt, Wwt, Dd^Es, Wwrt, Wwrt, Wwrt, Wwt, Wot, Wot, Wot, Wot, Wo, Wo, Wo, Ww, Wwr, Ww, Ww, Ss, Ss, Chw, Ww, Khw, Ww^Fet, Ss, Ss, Dd^Es, Dd^Es, Ss, Dd^Es, Dd^Es, Dd^Es, Ww, Ww, Dd^Es, Dd, Dd, Dd^Es
Wwt, Dd^Es, Dd^Vhs, Wwrt, Wwrt, Wwt, Wot, Wot, Wot, Wot, Wo, Wo, Wo, Ww, Ww, Ww, Gs^Ft, Ww, Ww, Gs^Ft, Ww^Fet, Chw, Chw, Chw, Ww^Fet, Ss, Dd^Es, Dd^Es, Ss, Ss, Ss, Ss, Ww, Ss, Dd^Es, Dd^Vdt, Dd^Es, Dd^Es
Wwt, Dd^Es, Wwrt, Dd^Es, Wwrt, Wwt, Wot, Wot, Wot, Wo, Wo, Wwr, Ww, Ww, Ss, Ss, Ss, Gs^Ft, Ss, Ww, Ww^Ewl, Ww, Ss, Ss^Bw|, Ss, Ss, Ss, Ss, Dd^Ftd, Ss, Ww, Ww, Ss, Ss, Dd^Es, Dd^Es, Hh^Ft, Gs^Ft
Wwt, Ds^Es, Wwrt, Wwrt, Wwrt, Wot, Wot, Wot, Wo, Wo, Wwr, Ww, Ww, Ww, Ss, Ss^Vhs, Dd^Ftd, Dd^Ftd, Ss, Ss, Ss, Ww^Ewl, Ss, Dd, Dd, Dd^Es, Dd, Ss, Dd^Ftd, Ss, Ww, Ss, Gs^Ft, Gs^Ft, Dd^Ftd, Hh^Ft, Gs^Ft, Ss
Wwt, Wwrt, Wwt, Wwrt, Wot, Wot^Bw\r, Wot^Bw\r, Wot, Wo, Wo, Ww, Ww, Wwf, Ss, Dd^Ftd, Ss, Ss, Dd, Dd^Es, Dd^Ftd, Ss, Ss, Dd^Ftd, Ss, Dd^Es, Dd^Vdt, Dd^Es, Ss, Dd^Ftd, Ww, Ww, Ss, Dd, Dd^Ftd, Ss, Gs^Ft, Ss, Ss
Wot, Wwt, Wwt, Wwrt, Wot, Wot, Wot, Wot^Bw\r, Wo^Bw\r, Ww, Ww, Wwf, Ss, Ss, Ss, Dd, Dd, Dd^Es, Dd^Es, Ss, Dd, Dd, Dd^Es, Ss, Ss, Dd^Es, Ss, Dd^Es, Ww, Ww, Gs^Ft, Ww, Ww, Ss, Ss, Ss, Gg^Efm, Gg^Efm
Wot, Wwt, Wwt, Wot, Wot, Wot, Wo, Wwr, Wwr, Wwr, Wwf^Bw\r, Wwf, Ss, Ss, Dd^Es, Dd, Ss, Ss, Ss, Ss, Dd, Dd^Dr, Dd^Es, Dd, Ss, Ss, Ss, Ww, Ss, Gs^Ft, Gs^Ft, Gg^Fet, Ds, Ds, Ds, Gg^Efm, Gs^Ft, Hh^Ft
Wot, Wot^Vm, Wot, Wot, Wot, Wot, Wo, Wo, Wwr, Wwr, Wwf, Dd, Dd^Ftd, Ss, Dd, Dd^Es, Ss, Ss, Ss, Dd^Es, Dd^Es, Dd, Hh^Ft, Dd, Ds, Dd^Ftd, Ww, Ww, Ss, Gs^Ft, Gs^Ft, Gg^Fet, Gg^Fet, Ds, Gg^Fet, Gg^Fet, Hh^Ft, Hd^Ftd
Wot, Wot, Wot, Wot, Wot, Wo, Wo, Wwr, Wwr, Wwf, Wwf, Dd, Ss, Dd^Es, Ss, Dd^Es, Ss, Ss, Ss, Dd^Es, Ss, Gs^Ft, Gs^Ft, Dd^Ftd, Dd, Ww^Bw\, Dd, Ss, Dd^Ftd, Ss, Gs^Ft, Hh^Ft, Hh^Ft, Gg^Fet, Gs^Ft, Gs^Ft, Hd^Ftd, Hd^Ftd
Wot, Wot, Wot, Wot, Wo, Wo, Wo, Wwr, Wwr, Wwf, Dd, Dd^Ftd, Gs^Ft, Ss, Ss^Vhs, Ss, Gs^Ft, Gs^Ft, Gs^Ft, Ss, Ss, Ss, Ss, Ss, Ww, Ww, Dd^Es, Dd^Es, Dd^Vda, Dd^Ftd, Ss, Gs^Ft, Gs^Ft, Hh^Ft, Hh^Ft, Hh^Ft, Hd^Ftd, Md
Wot, Wot, Wot, Wot, Wo, Wo, Ww, Ww, Wwf, Wwf, Dd^Ftd, Gs^Ft, Gs^Ft, Ss, Gs^Ft, Ss, Ss, Hh^Ft, Gs^Ft, Ss, Ww, Ww, Ww, Ww, Ss, Ss, Ss, Dd^Es, Dd, Dd, Dd^Ftd, Dd^Ftd, Ss, Hh^Ft, Hd^Ftd, Hd^Ftd, Md, Md
Wot, Wot, Wot, Wot, Wo, Wo, Ww, Ww, Wwf, Dd, Gs^Ft, Gs^Ft, Dd^Es, Gs^Ft, Dd^Es, Gs^Ft, Gs^Ft, Hh^Ft, Gs^Ft, Ww, Ss, Ss, Gs^Ft, Gs^Ft, Dd^Es, Ss, Dd^Es, Ss, Ss, Dd^Es, Dd^Es, Dd^Ftd, Dd^Ftd, Dd^Ftd, Hd^Ftd, Md, Md, Md
Wot, Wot, Wot, Wo, Wo, Wo, Ww, Wwf, Ds, Dd, Dd^Es, Dd^Es, Rd, Dd, Rd, Dd^Es, Dd^Es, Gs^Ft, Ww, Ww, Ss, Dd^Es, Dd^Es, Dd^Ftd, Dd^Es, Dd^Es, Ss, Ss, Gs^Ft, Dd, Dd^Ftd, Dd, Dd^Ftd, Dd^Ftd, Hd^Ftd, Md, Md, Md
Wot, Wot, Wo, Wo, Wo, Wwr, Ww, Wwf, Chw, Ce, Ce, Rd, Dd, Rd, Dd^Es, Rd, Ww^Bw\, Ww, Dd, Dd^Es, Dd^Es, Ss, Ss, Gs^Ft, Gs^Ft, Gs^Ft, Ss, Ss, Gs^Ft, Gs^Ft, Gs^Ft, Dd^Ftd, Dd^Es, Dd^Ftd, Dd^Ftd, Hd^Ftd, Md, Md
Wot, Wot, Wo, Wo, Wo, Wwr, Ww, Ww, Chw, 3 Ke, Ce, Dd, Ss, Dd^Es, Ss, Ww, Dd^Es, Rd^Es, Rd, Rd, Rd, Gs^Ft, Ss, Ss, Ss, Ss, 4 Dd, Ss, Ss, Ss, Dd^Ftd, Dd^Es, Dd^Ftd, Dd^Ftd, Dd^Ftd, Hd^Ftd, Md, Md
Wot, Wo, Wo, Wo, Ww, Ww, Ww, Ss, Ss, Ce, Dd^Es, Dd^Es, Gs^Ft, Ss, Ww, Ww, Ss, Dd^Es, Ss, Gs^Ft, Ss, Ss^Bw\, Rd, Gs^Ft, Dd, Dd, Dd, Dd, Dd, Dd, Dd^Ftd, Dd^Ftd, Ss, Dd^Ftd, Ss^Vhs, Dd^Ftd, Hd, Md
Wo, Wo, Wo, Wo, Ww, Ww, Dd^Ftd, Ss, Ss, Dd, Dd^Ftd, Ss, Ss, Ss, Ww, Ss, Ss, Ss, Dd^Ftd, Ss, Dd^Es, Gs^Ft, Gs^Ft, Rd, Rd, Dd^Es, Dd^Es, Dd^Es, Dd, Dd^Ftd, Dd^Ftd, Ss, Ss, Ss, Dd^Ftd, Dd^Ftd, Mm, Md
Wo, Wo, Wo, Ww, Ww, Ww, Dd^Ftd, Dd^Es, Ss, Gs^Ft, Gs^Ft, Ss, Ww, Ww, Ss, Ss, Ss, Ss, Gs^Ft, Dd, Dd^Vda, Dd^Es, Dd, Dd, Dd^Es, Rd, Rd, Rd, Rd, Dd^Ftd, Dd^Ftd, Ww, Dd^Ftd, Dd^Ftd, Hd^Fts, Hd^Fts, Mm, Md
Wo, Wo, Ww, Ww, Dd^Ftd, Dd^Ftd, Dd^Es, Ss, Ss^Vhs, Ss, Ss, Ss, Ww, Ww, Gs^Ft, Gs^Ft, Dd^Ftd, Ss, Ss, Dd^Ftd, Dd, Dd, Hd^Ftd, Hd^Ftd, Hd^Ftd, Dd^Es, Dd, Dd, Dd^Ftd, Rd, Hd, Ww, Dd^Ftd, Hd^Fts, Md, Hd^Ftd, Md, Md
Ww, Wo, Ww, Ww, Dd^Ftd, Dd^Ftd, Ss, Ss, Ww, Ww, Ww, Ww, Gs^Ft, Dd^Ftd, Dd, Dd^Ftd, Dd^Ftd, Dd^Ftd, Dd^Ftd, Gs^Ft, Gs^Ft, Gs^Ft, Hd^Ftd, Md, Md, Hd^Ftd, Hd^Ftd, Hd^Fts, Dd^Ftd, Rd, Hd^Ftd, Hd, Md, Md, Md, Md, Md, Md
