border_size=1
usage=map

Ha^Fpa, Ms, Ms, Ms, Ms, Ms, Ms, Ha, Ai, Ha, Ai, Aa, Aa, Ha^Fma, Ha^Fpa, Ms, Ms, Ms, Ha^Fma, Ms, Ha^Fma, Aa, Ai, Ai, Ha^Fma, Ha, Aa, Aa, Gs^Es, Gs, Gs^Es, Aa, Dd, Dd, Ww, Ww, Wwt, Wwt, Wwt, Wot, Wot, Wot, Wot, Wot, Wo, Ww, Ww, Ww
Ha^Fpa, Ha^Fpa, Ms, Ha^Fpa, Ha^Fpa, Ha^Fpa, Ha^Fpa, Ha^Vaa, Ha^Fpa, Ai, Ha^Fma, Ai, Ai, Aa, Ha^Fma, Ha^Fma, Ha^Fpa, Ha^Fma, Aa, Ha^Fma, Aa, Aa, Ai, Aa, Aa^Fda, Aa, Aa^Fda, Gs, Gs^Es, Gs^Vht, Dd, Dd, Ww, Ww, Ww, Ww, Wwt, Wwt, Wot, Wot, Wot, Wot, Wo, Wo, Ww, Ww, Ww, Ww
Ha^Fpa, Ha^Fpa, Ha^Fpa, Ha^Fpa, Aa, Hh^Fdw, Hh^Fdw, Ha^Fpa, Hh^Fdw, Ha^Fma, Aa^Fma, Aa^Fma, Ai, Aa, Aa, Aa, Aa, Aa, Ha^Fda, Aa, Aa, Aa^Fda, Ww, Aa^Fda, Gs, Aa^Fda, Gs^Es, Gs^Es, Dd^Es, Dd, Ww, Ww, Wwt, Ww, Wwt, Wwt, Wwt, Wot, Wot, Wot, Wot, Wot, Wo, Wo, Ww, Ww, Ww, Ww
Aa, Aa, Ha^Fpa, Aa, Gs, Gs^Es, Hh^Fdw, Hh^Fdw, Aa, Ha^Fpa, Ww, Ai, Ai, Ha^Fda, Ha^Fda, Rd, Aa, Aa^Vaa, Ha^Fda, Aa, Gs, Gs, Ss, Gs, Ss, Gs, Gs^Es, Gs^Es, Dd, Ww, Ww, Ww, Wwt, Wwt, Wwt, Wwt, Wot, Wot, Wot, Wot, Wo, Wo, Wo, Wo, Ww, Ww, Ww, Dd
Gg, Aa, Aa^Fma, Aa, Gs^Fp, Gs^Es, Gs^Es, Gs, Ha^Fda, Aa, Ss, Ai, Ss, Ha^Fda, Rd, Rd, Aa, Ha^Fda, Aa^Fpa, Aa^Fpa, Gs, Ss, Ss, Ss, Ss^Vhs, Ss, Ss, Dd, Ww, Ww, Wwt, Wwt, Wwt, Wot, Wot, Wot, Wot, Wot, Wo, Wo, Wo, Wo, Ww, Ww, Ww, Ww, Dd^Es, Dd
Gg, Gg, Aa^Fma, Gs^Fp, Aa^Fma, Aa, Ha^Fda, Ha^Fda, Ha^Fma, Ss, Ss^Vhs, Ss, Ss, Ss, Rd, Aa, Aa, Aa^Fma, Gs^Fp, Aa^Fma, Gs, Gs^Fp, Ss, Ww^Ewl, Ww^Ewl, Ss, Ww, Ww, Ww, Wwt, Wwt, Wwt, Wot, Wot, Wot, Wot, Wo, Wo, Wo, Wo, Ww, Ww, Ww, Ww, Ww, Ww, Dd^Es, Mm
Aa, Gg^Vo, Aa, Gs^Fp, Aa, Ha^Fma, Gs^Fp, Ha^Fma, Ss, Ss, Ss, Aa, Rd, Ss^Bw/, Ss, Aa, Ss, Aa^Fma, Gs, Gs, Gs^Es, Gs, Ss, Ww^Ewl, Ww, Ww, Ww, Ww, Wwt, Wwt, Wot, Wot, Wot, Wot, Wo, Wo, Wo, Wo, Ww, Ww, Ww, Ww, Ww^Fet, Ww, Dd, Dd, Dd^Es, Mm
Ha^Fma, Aa, Aa, Aa, Aa^Fma, Ha^Fma, Ss, Ss, Ha^Fma, Ha^Fma, Aa, Aa, Aa, Aa, Ss, Ss, Ss, Gs, Dd^Es, Gs^Es, Dd, Ss, Ww, Ww, Ww, Ww, Wwt, Wwt, Wwt, Wwt, Ww^Vm, Wot, Wot, Wo, Wo, Wo, Wo, Ww, Ww, Ww, Ww^Fet, Ww^Vm, Ds, Ww, Wwt, Wwt, Wwt, Dd
Aa, Ha^Fda, Aa, Aa, Ss, Ss, Ha^Fma, Ss, Aa, Aa, Rd, Rd, Aa, Aa, Aa, Ss, Ss, Dd, Dd, Dd, Dd, Ss, Ww, Ww, Ww, Ww, Ww, Wwt, Wwt, Wwt, Wot, Wot, Wot, Wo, Wo, Wo, Ww, Ww, Ww, Ww, Ww, Ds, Ha, Dd, Dd, Dd^Es, Dd^Es, Wwt
Rd, Aa, Aa, Ai, Aa, Aa, Ha^Fma, Aa^Fda, Rd, Aa, Aa, Aa, Aa, Ha, Aa^Voa, Aa, Dd, Ss, Ww, Ww, Wwf, Ww, Ww, Ww, Ww, Wo, Wot, Wo, Wot, Wot, Wot, 1 Wot, Wo, Wo, Wo, Wo, Ww, Ww, Ww, Ww, Dd, Dd, Mm, Mm, Mm, Mm, Md, Dd^Es
Gs, Rd, Ai^Bw\, Ai, Aa, Aa, Aa, Aa, Rd, Aa, Gs^Es, Gs^Es, Gs^Es, Aa, Aa, Aa, Dd, Dd, Ww, Ww, Wwf, Ww, Wo, Wo, Wo, Wot, Wot, Wot, Wot, Wot, Ww, Wo, Wo, Wo, Wo, Ww, Ww, Ww, Ww, Dd, Hd^Ftd, Mm, Ha, Ha, Dd^Es, Hd^Ftd, Hd^Ftd, Mm
Ai, Aa, Ss, Aa, Aa, Rd, Rd, Aa, Aa, Gs^Es, Ss, Dd^Es, Dd, Dd, Dd, Dd, Wwf, Ww, Wwf, Wwf, Ww, Ww, Wwt, Wwt, Wwt, Wot, Wo, Wo, Wo, Wo, Ww, Ww, Wo, Wo, Ww, Ww, Ww, Ww, Dd, Hd^Ftd, Mm, Mm, Hd^Ftd, Dd, Dd^Vht, Aa, Ha, Mm
Gs, Ss, Gs, Gs, Co, Coa, Coa, Aa, Gg, Gg, Gg, Ss, Ss, Wwf, Wwf, Dd, Wwf, Ww, Wwf, Ww^Vm, Ww, Wwt, Wwt, Wot, Wot, Wot, Wo, Ww, Ww, Ww, Wwr, Wwr, Wo, Wo, Ww, Ww, Ss, Dd, Ha, Hd^Ftd, Mm, Hd^Ftd, Dd^Es, Dd^Es, Dd^Es, Aa, Dd^Es, Hd^Ftd
Gs, Ss, Ss, Gs, Chr, 3 Koa, Co, Aa, Gs, Gg^Vo, Gg, Ss, Ww, Ww, Wwf, Wwf, Wwr, Wwf, Wwr, Wwr, Wwt, Wwt, Wot, Wot, Wot, Wo, Ww, Ww, Wwf, Wwr, Wo, Wo, Wo, Ww, Ww, Ww, Dd, Dd, Hd^Ftd, Mm, Mm, Ha, Ha, Dd^Es, Dd^Es, Ss, Ss, Dd^Es
Ss, Ss, Rp, Rp, Rp, Chr, Rp, Gs, Ss, Gg, Ss, Ss, Ww, Wwf, Wwr, Wwr, Wwrt, Wwr, Wwt, Wwt, Wot, Wot, Wot, Wot, Wo, Wo, Wwf, Wwf, Ww, Wo, Wo, Wo, Ww, Ww^Vhs, Ww, Ss, Dd, Ha, Mm, Mm, Mm, Ms, Ha, Aa, Ss, Ss, Ss, Ss
Ss, Ss, Ww^Bw/, Rp, Rp, Rp, Rp, Ss, Ss, Ss, Ww, Ww, Wwr, Wwr, Wwt, Wwt, Wwt, Wwt, Wwt, Wwt, Wot, Wot, Wdz^Kwy, Wdz, Ww, Ww^Vm, Wwf, Ww, Wo, Wo, Ww, Ww, Ww, Ww, Ss, Ss, Dd^Es, Ha, Hd^Ftd, Mm, Mm, Ms, Ha, Dd^Es, Dd, Ss, Aa, Ss
Ww, Ww, Ww, Ww^Bw/, Ww^Bw/, Rp, Dd^Es, Dd, Ss, Ss, Ww, Wwr, Wwrt, Wwt, Wot, Wot, Wot, Wot, Wot, Wwrt, Wdz, Wdz, Wwt, Ww, Wwrg, Ww, Wwf, Ww, Wo, Wo, Ww, Ww, Dd, Ss, Dd^Es, Dd^Es, Hd^Ftd, Hd^Ftd, Mm, Mm, Hd^Ftd, Ha, Aa, Dd^Es, Ww, Ss, Dd, Aa
Ww, Ww, Ww, Ww, Ww, Dd, Dd^Vo, Dd, Ww, Ww, Wwt, Wwt, Wwrt, Wwrt, Wot, Wot, Wot, Wot, Wot, Wdz, Wot, Wot, Wwrt, Wwr, Ww, Wwf, Ww, Ww, Wo, Ww, Ww, Ww, Dd^Es, Dd, Ha, Ha, Mm, Mm, Mm, Hd^Ftd, Hd^Ftd, Dd^Es, Ss, Ss, Ww, Dd^Es, Dd^Es, Dd
Wot, Ww, Ww, Ww, Dd, Dd^Es, Dd, Dd, Ww, Ww, Wwt, Wot, Wot, Wwrt, Wwrt, Wwt, Wot, Wot, Wot, Wot, Wot, Wwt, Wwrt, Ww, Wwf, Wwf, Wwf, Wo, Ww, Ww, Ds, Ds, Aa, Dd^Es, Dd^Es, Ha, Ha, Ms, Ms, Mm, Hd^Ftd, Dd^Es, Dd^Es, Ss, Aa, Dd^Vht, Dd^Es, Wwt
Wwt, Wwt, Wwt, Ww, Dd, Dd, Ww, Ww, Wwrt, Wwt, Wot, Wot, Ww^Vm, Wwrt, Wsz, Wsz, Wot, Wot, Wot, Wot, Wot, Wot, Wwt, Ww, Wwf, Ww, Wwf, Wo^Bw\, Ww^Bw\, Ww, Ds, Aa, Aa, Dd^Vdt, Dd, Dd^Es, Aa, Ha, Ha, Md, Mm, Hd^Ftd, Dd^Es, Ss, Ss, Aa, Dd^Es, Dd
Wwt, Wwt, Wwt, Ww, Ww, Ww, Wwt, Wwt, Wwrt, Wwrt, Wot, Wot, Wot, Wot, Wdz, 2 Wdz^Kwy, Wdz, Wdz, Wot, Wot, Wwt, Wwt, Wo, Ww, Ww, Ww, Wo, Wo, Ww, Ds, Dd, Dd, Dd^Es, Dd, Ce, Ce, Ce, Aa, Ha, Ms, Ms, Ha, Aa, Aa, Ss, Ss, Dd^Es, Aa
Wot, Wwt, Wot, Wwt, Wwt, Wwt, Wwt, Wwrt, Wwrt, Wot, Wot, Wot, Wot, Wot, Wwrt, Wdz, Wot, Wot, Wot, Wot, Wwt, Wwt, Wo, Ww, Ww, Ww, Wo, Ww, Ww, Ds, Rd, Rd, Rd, Rd, Ce, 4 Ke, Ce, Ha, Ha, Ms, Ha, Ha, Aa, Ss, Dd^Es, Ss, Ss, Ss
Wot, Wot, Wot, Ww^Vm, Wot, Wot, Wot, Wot, Wwrt, Wwrt, Wot, Wwrt, Wwrt, Wwrt, Wwrt, Wwrt, Ww^Vm, Wot, Wot, Wwrt, Wwt, Wo, Wo, Wo, Wo, Wo, Wo, Ww, Ww, Ww^Bw/, Rd, Dd^Es, Dd, Dd, Dd^Es, Ce, Dd, Ha, Dd^Es, Ha, Dd^Es, Dd^Es, Ss, Ss, Dd^Es, Dd, Dd, Dd
Wot, Wot, Wot, Wot, Wot, Wot, Wot, Wot, Wot, Wot, Wot, Wot, Wwrt, Wot, Wot, Wot, Wot, Wot, Wwt, Wwrt, Wwrt, Wo, Wo, Wo, Ww^Vm, Wo, Ww, Ww, Ww, Ww^Bw/, Dd, Dd^Es, Dd^Vdt, Dd^Es, Dd, Dd, Dd^Es, Dd, Dd^Es, Dd, Dd^Es, Dd^Es, Ss, Dd, Aa, Dd^Es, Dd^Vdt, Aa
Wot, Wot, Wot, Wot, Wwrt, Wwrt, Wot, Wot, Wot, Wot, Wot, Wot, Wot, Wot, Wot, Wot, Wot, Wot, Wwt, Wwrt, Wo, Wo, Wo, Wo, Wo, Wo, Ww, Ww, Ww, Ww, Dd, Dd^Es, Dd^Es, Dd, Ss, Ss, Ss, Ss, Ss, Ss, Ss, Ss, Ss, Ss, Aa, Dd^Es, Aa, Aa
Wo, Wot, Wot, Wot, Wo, Wot, Wot, Wot, Wot, Wot, Wot, Wot, Wot, Wot, Wot, Wot, Wot, Wwt, Wo, Wo, Wo, Wo, Wo, Wo, Ww, Ww, Dd, Dd, Dd, Dd, Dd, Dd^Es, Aa, Dd, Dd, Dd, Dd, Dd, Ss, Ss, Ss^Vhs, Ss, Ss, Ss, Ss, Aa, Ha, Ha
Wot, Wot, Wot, Wot, Wot, Wot, Wot, Wot, Wot^Vm, Wot, Wot, Wot, Wot, Wot, Wot, Wot, Wot, Wot, Wo, Wo, Wo, Wo, Wo, Ww, Ww, Ww, Dd, Aa, Aa, Dd^Es, Aa, Aa, Ha, Aa, Aa, Dd^Es, Aa, Dd, Dd, Dd, Ss, Ss, Ss, Dd, Aa, Aa, Aa, Ha
Wot, Wot, Wot, Wot, Wot, Wot, Wot, Wot, Wot, Wot, Wot, Wot, Wot, Wot, Wot, Wot, Wot, Wo, Wo, Wo, Wo, Wo, Ww, Ww, Dd, Dd, Dd, Aa, Dd^Es, Aa, Aa, Ha, Ha, Ha, Ha, Ha, Aa, Aa, Dd, Dd, Dd, Dd, Dd, Dd, Dd, Dd^Es, Aa, Aa
