border_size=1
usage=map

Gs, Gs, Aa, Aa, Ha^Fpa, Ha, Ha, Ai, Ai, Ms, Ai, Ai, Ai, Ha^Fma, Ha^Fpa, Ms, Ms, Ms, Ha^Fma, Ms, Ha^Fma, Aa, Ai, Ai, Ha^Fma, Aa, Aa, Aa, Gs^Es, Gs, Gs^Es, Aa, Dd, Dd, Ww, Ww, Wwt, Wwt, Wwt, Wot, Wot, Wot, Wot, Wot, Wo, Ww, Ww, Ww
Gs, Gs, Gs, Aa, Aa, Ha^Fpa, Ha^Fpa, Ha^Vaa, Ha^Fpa, Ai, Ha^Fma, Ha^Fma, Ai, Aa, Ha^Fma, Ha^Fma, Ha^Fpa, Ha^Fma, Aa, Ha^Fma, Aa, Aa, Ai, Aa, Aa^Fda, Aa, Aa^Fda, Gs, Gs^Es, Gs^Vht, Dd, Dd, Ww, Ww, Ww, Ww, Wwt, Wwt, Wot, Wot, Wot, Wot, Wo, Wo, Ww, Ww, Ww, Ww
Aa, Aa, Gs, Aa, Aa, Hh^Fdw, Hh^Fdw, Ha^Fpa, Hh^Fdw, Ha^Fma, Aa^Fma, Aa^Fma, Ai, Aa, Aa, Aa, Aa, Aa, Aa, Aa, Aa, Aa^Fda, Ww, Aa^Fda, Gs, Aa^Fda, Gs^Es, Gs^Es, Dd^Es, Dd, Ww, Ww, Wwt, Ww, Wwt, Wwt, Wwt, Wot, Wot, Wot, Wot, Wot, Wo, Wo, Ww, Ww, Ww, Ww
Gs, Gs, Aa^Fma, Gs, Gs, Gs^Es, Hh^Fdw, Hh^Fdw, Aa, Ha^Fpa, Ww, Ai, Ai, Aa, Aa, Rd, Aa, Aa^Vaa, Aa, Aa, Gs, Gs, Ss, Gs, Ss, Gs, Gs^Es, Gs^Es, Dd, Ww, Ww, Ww, Wwt, Wwt, Wwt, Wwt, Wot, Wot, Wot, Wot, Wo, Wo, Wo, Wo, Ww, Ww, Ww, Dd
Gg, Aa^Fma, Aa^Fma, Aa, Gs^Fp, Gs^Es, Gs^Es, Gs, Aa, Aa, Ss, Ai, Ss, Ai, Rd, Rd, Aa, Aa, Aa^Fpa, Aa^Fpa, Gs, Ss, Ss, Ss, Ss^Vhs, Ss, Ss, Dd, Ww, Ww, Wwt, Wwt, Wwt, Wot, Wot, Wot, Wot, Wot, Wo, Wo, Wo, Wo, Ww, Ww, Ww, Ww, Dd^Es, Dd
Gg, Gg, Aa^Fma, Gs^Fp, Aa^Fma, Aa, Aa^Fma, Aa, Aa^Fma, Ss, Ss^Vhs, Ss, Ss, Ss, Rd, Aa, Aa, Aa^Fma, Gs^Fp, Aa^Fma, Gs, Gs^Fp, Ss, Ww^Ewl, Ww^Ewl, Ss, Ww, Ww, Ww, Wwt, Wwt, Wwt, Wot, Wot, Wot, Wot, Wo, Wo, Wo, Wo, Ww, Ww, Ww, Ww, Ww, Ww, Dd^Es, Mm
Gg, Gg^Vo, Aa, Gs^Fp, Aa, Aa^Fma, Gs^Fp, Aa^Fma, Ss, Ss, Ss, Aa, Rd, Ss^Bw/, Ss, Aa, Ss, Aa^Fma, Gs, Gs, Gs^Es, Gs, Ss, Ww^Ewl, Ww, Ww, Ww, Ww, Wwt, Wwt, Wot, Wot, Wot, Wot, Wo, Wo, Wo, Wo, Ww, Ww, Ww, Ww, Ww^Fet, Ww, Dd, Dd, Dd^Es, Mm
Aa, Gg, Gs, Aa, Aa^Fma, Aa^Fma, Ss, Ss, Aa^Fda, Aa^Fda, Aa, Aa, Aa, Aa, Ss, Ss, Ss, Gs, Dd^Es, Gs^Es, Dd, Ss, Ww, Ww, Ww, Ww, Wwt, Wwt, Wwt, Wwt, Ww^Vm, Wot, Wot, Wo, Wo, Wo, Wo, Ww, Ww, Ww, Ww^Fet, Ww^Vm, Ds, Ww, Wwt, Wwt, Wwt, Dd
Gg, Gg, Aa, Aa, Ss, Ss, Aa^Fda, Ss, Aa, Aa, Rd, Rd, Aa, Aa, Aa, Ss, Ss, Dd, Dd, Dd, Dd, Ss, Ww, Ww, Ww, Ww, Ww, Wwt, Wwt, Wwt, Wot, Wot, Wot, Wo, Wo, Wo, Ww, Ww, Ww, Ww, Ww, Ds, Hd^Ftd, Dd, Dd, Dd^Es, Dd^Es, Wwt
Rd, Gg, Aa, Ai, Aa, Aa, Aa, Aa^Fda, Rd, Aa, Aa, Aa, Aa, Aa, Aa^Voa, Aa, Dd, Ss, Ww, Ww, Wwf, Ww, Ww, Ww, Ww, Wo, Wot, Wo, Wot, Wot, Wot, 1 Wot, Wo, Wo, Wo, Wo, Ww, Ww, Ww, Ww, Dd, Dd, Mm, Mm, Mm, Mm, Md, Dd^Es
Gs, Rd, Ai^Bw\, Ai, Aa, Aa, Aa, Aa, Rd, Aa, Gs^Es, Gs^Es, Gs^Es, Aa, Aa, Aa, Dd, Dd, Ww, Ww, Wwf, Ww, Wo, Wo, Wo, Wot, Wot, Wot, Wot, Wot, Ww, Wo, Wo, Wo, Wo, Ww, Ww, Ww, Ww, Dd, Hd^Ftd, Mm, Hd^Ftd, Hd^Ftd, Dd^Es, Hd^Ftd, Hd^Ftd, Mm
Ai, Aa, Ss, Aa, Aa, Rd, Rd, Aa, Aa, Gs^Es, Ss, Dd^Es, Dd, Dd, Dd, Dd, Wwf, Ww, Wwf, Wwf, Ww, Ww, Wwt, Wwt, Wwt, Wot, Wo, Wo, Wo, Wo, Ww, Ww, Wo, Wo, Ww, Ww, Ww, Ww, Dd, Hd^Ftd, Mm, Mm, Hd^Ftd, Dd, Dd^Vht, Dd, Hd^Ftd, Mm
Gs, Ss, Gs, Gs, Co, Coa, Coa, Aa, Gg, Gg, Gg, Ss, Ss, Wwf, Wwf, Dd, Wwf, Ww, Wwf, Ww^Vm, Ww, Wwt, Wwt, Wot, Wot, Wot, Wo, Ww, Ww, Ww, Wwr, Wwr, Wo, Wo, Ww, Ww, Ss, Dd, Hd, Hd^Ftd, Mm, Hd^Ftd, Dd^Es, Dd^Es, Dd^Es, Dd, Dd^Es, Hd^Ftd
Gs, Ss, Ss, Gs, Chr, 3 Koa, Co, Aa, Gs, Gg^Vo, Gg, Ss, Ww, Ww, Wwf, Wwf, Wwr, Wwf, Wwr, Wwr, Wwt, Wwt, Wot, Wot, Wot, Wo, Ww, Ww, Wwf, Wwr, Wo, Wo, Wo, Ww, Ww, Ww, Dd, Dd, Hd^Ftd, Mm, Mm, Hd^Ftd, Hd^Ftd, Dd^Es, Dd^Es, Ss, Ss, Dd^Es
Ss, Ss, Rp, Rp, Rp, Chr, Rp, Gs, Ss, Gg, Ss, Ss, Ww, Wwf, Wwr, Wwr, Wwrt, Wwr, Wwt, Wwt, Wot, Wot, Wot, Wot, Wo, Wo, Wwf, Wwf, Ww, Wo, Wo, Wo, Ww, Ww^Vhs, Ww, Ss, Dd, Hd, Mm, Mm, Mm, Mm, Hd^Ftd, Dd, Ss, Ss, Ss, Ss
Ss, Ss, Ww, Rp, Rp, Rp, Rp, Ss, Ss, Ss, Ww, Ww, Wwr, Wwr, Wwt, Wwt, Wwt, Wwt, Wwt, Wwt, Wot, Wot, Wot^Kwy, Wo^Cwy, Ww, Ww^Vm, Wwf, Ww, Wo, Wo, Ww, Ww, Ww, Ww, Ss, Ss, Dd^Es, Hd, Hd^Ftd, Mm, Mm, Mm, Hd^Ftd, Dd^Es, Dd, Ss, Dd, Ss
Ww, Ww, Ww, Ww^Bw/, Ww^Bw/, Rp, Dd, Dd, Ss, Ss, Ww, Wwr, Wwrt, Wwt, Wot, Wot, Wot, Wot, Wot, Wwrt, Wot^Cwy, Wot^Cwy, Wwt, Ww, Wwrg, Ww, Wwf, Ww, Wo, Wo, Ww, Ww, Dd, Ss, Dd^Es, Dd^Es, Hd^Ftd, Hd^Ftd, Mm, Mm, Hd^Ftd, Hd^Ftd, Dd, Dd^Es, Ww, Ss, Dd, Dd
Ww, Ww, Ww, Ww, Ww, Dd, Dd^Vo, Dd, Ww, Ww, Wwt, Wwt, Wwrt, Wwrt, Wot, Wot, Wot, Wot, Wot, Wot^Cwy, Wot, Wot, Wwrt, Wwr, Ww, Wwf, Ww, Ww, Wo, Ww, Ww, Ww, Dd^Es, Dd, Hd, Hd^Es, Mm, Mm, Mm, Hd^Ftd, Hd^Ftd, Dd^Es, Ss, Ss, Ww, Dd^Es, Dd^Es, Dd
Wot, Ww, Ww, Ww, Dd, Dd, Dd, Dd, Ww, Ww, Wwt, Wot, Wot, Wwrt, Wwrt, Wwt, Wot, Wot, Wot, Wot, Wot, Wwt, Wwrt, Ww, Wwf, Wwf, Wwf, Wo, Ww, Ww, Ds, Ds, Dd, Dd^Es, Dd^Es, Hd^Es, Hd^Ftd, Mm, Mm, Mm, Hd^Ftd, Dd^Es, Dd^Es, Ss, Dd, Dd^Vht, Dd^Es, Wwt
Wwt, Wwt, Wwt, Ww, Dd, Dd, Ww, Ww, Wwrt, Wwt, Wot, Wot, Ww^Vm, Wwrt, Chw, Chw, Wot, Wot, Wot, Wot, Wot, Wot, Wwt, Ww, Wwf, Ww, Wwf, Wo^Bw\, Ww^Bw\, Ww, Ds, Dd, Dd^Es, Dd^Vdt, Dd, Dd^Es, Dd, Hd^Ftd, Hd^Ftd, Md, Mm, Hd^Ftd, Dd^Es, Ss, Ss, Dd, Dd^Es, Dd
Wwt, Wwt, Wwt, Ww, Ww, Ww, Wwt, Wwt, Wwrt, Wwrt, Wot, Wot, Wot, Wot, Wot^Cwy, 2 Wot^Kwy, Chw, Chw, Wot, Wot, Wwt, Wwt, Wo, Ww, Ww, Ww, Wo, Wo, Ww, Ds, Dd, Dd, Dd^Es, Dd, Ce, Ce, Ce, Dd, Dd^Es, Hd^Ftd, Mm, Hd^Ftd, Dd^Es, Dd, Ss, Ss, Dd^Es, Dd
Wot, Wwt, Wot, Wwt, Wwt, Wwt, Wwt, Wwrt, Wwrt, Wot, Wot, Wot, Wot, Wot, Wwrt, Chw, Wot, Wot, Wot, Wot, Wwt, Wwt, Wo, Ww, Ww, Ww, Wo, Ww, Ww, Ds, Rd, Rd, Rd, Rd, Ce, 4 Ke, Ce, Dd^Es, Dd^Es, Hd^Ftd, Hd^Ftd, Hd^Ftd, Dd, Ss, Dd^Es, Ss, Ss, Ss
Wot, Wot, Wot, Ww^Vm, Wot, Wot, Wot, Wot, Wwrt, Wwrt, Wot, Wwrt, Wwrt, Wwrt, Wwrt, Wwrt, Ww^Vm, Wot, Wot, Wwrt, Wwt, Wo, Wo, Wo, Wo, Wo, Wo, Ww, Ww, Ww^Bw/, Rd, Dd^Es, Dd, Dd, Dd^Es, Ce, Dd, Dd^Es, Dd^Es, Hd, Dd^Es, Dd^Es, Ss, Ss, Dd^Es, Dd, Dd, Dd
Wot, Wot, Wot, Wot, Wot, Wot, Wot, Wot, Wot, Wot, Wot, Wot, Wwrt, Wot, Wot, Wot, Wot, Wot, Wwt, Wwrt, Wwrt, Wo, Wo, Wo, Ww^Vm, Wo, Ww, Ww, Ww, Ww^Bw/, Dd, Dd^Es, Dd^Vdt, Dd^Es, Dd, Dd, Dd^Es, Dd, Dd^Es, Dd, Dd^Es, Dd^Es, Ss, Dd, Dd, Dd^Es, Dd^Vdt, Dd
Wot, Wot, Wot, Wot, Wwrt, Wwrt, Wot, Wot, Wot, Wot, Wot, Wot, Wot, Wot, Wot, Wot, Wot, Wot, Wwt, Wwrt, Wo, Wo, Wo, Wo, Wo, Wo, Ww, Ww, Ww, Ww, Dd, Dd^Es, Dd^Es, Dd, Ss, Ss, Ss, Ss, Ss, Ss, Ss^Vhs, Ss, Ss, Ss, Dd, Dd^Es, Dd^Es, Dd
Wo, Wot, Wot, Wot, Wo, Wot, Wot, Wot, Wot, Wot, Wot, Wot, Wot, Wot, Wot, Wot, Wot, Wwt, Wo, Wo, Wot, Wo, Wot, Wo, Ww, Ww, Dd, Dd, Dd, Dd, Dd, Dd^Es, Ds^Es, Dd, Dd, Dd, Dd, Dd, Dd, Ss, Ss, Ss, Ss, Ss, Ss, Dd, Hd^Ftd, Hd^Ftd
