border_size=1
usage=map

Wwrt, Wwrt, Wwrt, Wot, Wot, Wot, Wot, Wot, Wot, Wot, Wot, Wot, Wot, Wot, Wot, Wot, Wot, Wot, Wot, Wo, Wot, Wot, Wot, Wot, Wot, Wot, Wot, Wot, Wot, Wot, Wot
Wwrt, Wwrt, Wot, Wot, Wwrt, Wot, Wot, Wot, Wot, Wot, Wot, Wot, Wot, Wot, Wot, Wot, Wot, Wot, Wot, Wwrt, Wwrt, Wot, Wot, Wot, Wot, Wot, Wot, Wot, Wot, Wot, Wot
Wwrt, Wot, Wwt, Wwrt, Wwrt, Wot, Wwrt, Wot, Wot, Wot, Wot, Wwrt, Wwrt, Wot, Wot, Wot, Wwrt, Wot, Wot, Wwrt, Wot, Wot, Wot, Wot, Wot, Wot, Wot, Wot, Wot, Wot, Wot
Wot, Wwrt, Wwrt, Wot, Ww^Vm, Wwrt, Ww^Vm, Wot, Wot, Wot, Wot, Wot, Wwrt, Wwrt, Wwrt, Wwrt, Wwrt, Wwrt, Wwrt, Wot, Wwrt, Wot, Wwrt, Wot, Wwrt, Wot, 1 Wot, Wot, Wot, Wot, Wot
Wot, Wot, Wwrt, Wot, Wot, Wot, Wot, Wwrt, Wot, Wot, Wot, Wwrt, Wot, Wwrt, Wot, Wwrt, Wot, Wot, Wot, Wot, Wot, Wwrt, Wwrt, Wwrt, Wot, Wot, Wot, Wot, Wot, Wot, Wot
Wot, Wwrt, Wwrt, Wot, Wwrt, Wwrt, Wwrt, Wwrt, Wwrt, Wot, Wot, Wot, Wot, Ww^Vm, Wot, Wot, Wot, Wot, Wot, Wot, Wot, Wot, Wwrt, Wot, Wot, Wot, Wwrt, Wot, Wwrt, Wot, Wot
Wot, Wot, Wwrt, Wot, Wwrt, Wwrt, Wwrt, Chw, Chw, Chw, Khw, Wwrt, Wwrt, Wot, Wwf, Wwt, Wwt, Wot, Wot, Wot, Wot, Wwrt, Wwrt, Wwrt, Wot, Wot, Wwrt, Wwrt, Wwrt, Wot, Wot
Wot, Wot, Ww^Vm, Wwt, Ww^Vm, Wwt, Wwrt, Chw, Wwt^Fet, Wwt^Fet, Chw, Chw, Ds, Wwf, Hd, Ds, Ds, Wwt, Wot, Wot, Wot, Wot, Wwrt, Wwrt, Wwrt, Wwrt, Wwrt, Ww^Vm, Wwrt, Wot, Wot
Wot, Wot, Wwrt, Wot, Wot, Wwt, Wwt, Wwf, Wwf, Ds, Ds, Wwt, Hd^Ftd, Hd, Md^Xm, Hd, Hd, Wwt, Wwt, Wot, Wot, Wot, Wot, Wot, Wot, Wot, Wot, Wwrt, Wot, Wot, Wot
Wot, Wwrt, Wot, Wot, Wot, Wwrt, Wwt, Ds, Ds, Ds, Hd^Ftd, Hd^Ftd, Md^Xm, Md^Xm, Wwt, Md^Xm, Md^Xm, Hd, Wwt, Wot, Wwt, Wot, Wot, Wot, Wot, Wot, Wot, Wot, Wot, Wot, Wwt
Wot, Wwrt, Wot, Wot, Wot, Wwrt, Ds, Ds, Hd, Hd, Md^Xm, Md^Xm, Hd^Ftd, Ww^Ewl, Wot, Wwt^Ewl, Md^Xm, Hd^Ftd, Hd^Ftd, Wwt, Hd, Wwt, Wwt, Wot, Wot, Wot, Wot, Wot, Wwt, Wwt, Hd
Wot, Wwrt, Wot, Wwrt, Wot, Wot, Ds, Hd, Md, Md^Xm, Hd^Ftd, Hd^Ftd, Wwrt, Wot, Wot, Wwt, Dd^Ftd, Md^Xm, Md^Xm, Hd^Ftd, Md^Xm, Hd, Hd, Wwt, Wwt, Wot, Wwt, Wwt, Hd, Hd, Md^Xm
Wot, Wot, Wot, Wot, Wot, Wwrt, Ds, Hd^Ftd, Hd^Ftd, Md^Xm, Hd^Ftd, Wwrt, Wot, Wot, Wwt, Dd, Hd, Dd^Vdt, Hd, Md^Xm, Hd^Ftd, Md^Xm, Md^Xm, Hd, Hd, Hd, Hd, Hd, Md^Xm, Md^Xm, Hd
Wot, Wot, Wot, Ww^Vm, Wot, Wot, Wwt, Dd, Hd^Ftd, Md^Xm, Hd, Wwrt, Wwrt, Wot, Wwrt, Wwrt, Wwrt, Dd, Ww, Hd^Ftd, Wwt, Hd^Ftd, Hd^Ftd, Md^Xm, Md^Xm, Md^Xm, Md^Xm, Md^Xm, Hd, Hd, Wot
Wot, Wot, Wwrt, Wwrt, Wot, Wot, Wwt, Dd, Hd^Ftd, Md^Xm, Hd, Hd, Wwt, Wwrt, Wot, Wwrt, Wot, Wwrt, Wwrt, Wwrt, Wot, Wwt, Wwrt, Hd^Ftd, Hd^Ftd, Dd^Vdt, Hd, Hd, Wwrt, Wot, Wot
Wot, Wot, Wot, Wwrt, Wot, Wot, Wwrt, Ds, Hd^Ftd, Md^Xm, Hd, Wwt, Wot, Wwrt, Wwrt, Wot, Wot, Wot, Wot, Wwrt, Wwrt, Wot, Wwrt, Wwrt, Wwt, Wwt, Wwt, Wwrt, Wwrt, Wwrt, Wot
Wot, Wot, Wot, Wot, Wot, Wot, Wwt, Dd, Md^Xm, Md^Xm, Hd^Ftd, Wwt, Wot, Wwrt, Wwt, Wot, Wwt, Wot, Wwt, Wot, Wwrt, Wwrt, Wot, Wot, Wot, Wwt, Wwt, Wwrt, Wot, Wwrt, Wot
Wwt, Wwf, Wwt, Wot, Wot, Wot, Wwt, Dd, Dd, Hd^Ftd, Wwrt, Wwrt, Wwrt, Wwrt, Wwrt, Wwt, Wwrt, Wwt, Wwt, Wwt, Wwrt, Wwt, Wwt, Wot, Wwt, Wwt, Wwrt, Wot, Wot, Ww^Vm, Wot
Wwt, Wwt, Wwt, Wot, Wot, Wot, Wot, Wwt, Wwt, Wwt, Wot^Vm, Wot, Wwrt, Wwrt, Wwt, Wwrt, Wwrt, Wwrt, Wwf, Wwt, Wwf, Wwt, Wwrt, Wwrt, Wwrt, Dd, Wwt, Wwrt, Wwt, Wot, Wot
Wwt, Wwt, Wot, Wot, Wot, Wot, Wot, Wot, Wot, Wot, Wot, Wot, Wwt, Wwt, Wwt, Wwrt, Ds, Wwf, Ds, Wwf, Ds, Wwf, Hd, Wwrt, Wwrt, Wwrt, Wwrt, Wwrt, Wwt, Wot, Wot
Wwt, Wwt, Wwt, Wwt, Wwt, Wwt, Wwt, Wot, Wot, Wot, Wwt, Wot, Wwt, Wwt, Ds, Ds, Hd^Ftd, Ds, Hd^Ftd, Ds^Vhs, Hd^Ftd, Hd, Hd, Ds, Wwt, Wwt, Chw, Cwz, Cwz, Wwrt, Wwrt
Dd, Wwt, Dd^Vhs, Wwt, Wwt, Wwt, Wwt, Wot, Wwt, Wwt, Wwt, Wwt, Wwt, Wwt, Hd^Ftd, Hd^Ftd, Md^Xm, Hd^Ftd, Md^Xm, Hd^Ftd, Md^Xm, Md^Xm, Hd, Ds, Wwrt, Wot, Chw, 3 Khw, Chw, Wwrt, Wo
Hd, Dd, Hd, Hd, Hd^Ftd, Ds, Wwt, Wwt, Wwt, Wwt, Ds, Wwt, Hd^Ftd, Hd^Ftd, Md^Xm, Md^Xm, Hd^Ftd, Md^Xm, Hd^Ftd, Md^Xm, Hd^Ftd, Hd, Ds, Wwrt, Wwrt, Wwrt, Wwrt, Wdz, Wot, Wwt, Wwt
Md^Xm, Hd^Ftd, Md^Xm, Md^Xm, Md^Xm, Hd^Ftd, Hd^Ftd, Wwt, Hd^Ftd, Hd^Ftd, Hd^Ftd, Dd^Ftd, Md^Xm, Md^Xm, Hd^Ftd, Hd^Ftd, Dd, Hd^Ftd, Dd, Hd^Ftd, Ds, Ds, Wwrt, Ww, Dd, Wwrt, Ww^Vm, Wot, Wot, Wot, Wot
Hd^Ftd, Md^Xm, Hd^Ftd, Hd^Ftd, Hd^Ftd, Md^Xm, Md^Xm, Hd^Ftd, Md^Xm, Md^Xm, Md^Xm, Md^Xm, Hd^Ftd, Hd^Ftd, Ds, Ds, Ds, Dd^Vda, Ds, Ds, Wwrt, Wwrt, Wwrt, Wot, Wot, Wwt, Wwt, Wot, Wot, Wot, Wot
Ds, Hd^Ftd, Wwt, Wwt, Ds, Hd^Ftd, Hd^Ftd, Md^Xm, Hd^Ftd, Hd^Ftd, Hd^Ftd, Hd^Ftd, Ds, Dd, Ds, Wwt, Wwt, Wwrt, Wwrt, Wwrt, Wwt, Wot, Wot, Wot, Wwrt, Wwrt, Wot, Wot, Wwrt, Wot, Wot
Wo, Ds, Wwt, Wwt, Wwt, Ds, Ds, Hd^Ftd, Ds, Ds, Ds, Ds, Wwt, Ds, Wwrt, Wwt, Wwt, Wwt, Wot, Wwt, Wot, Wot, Wwt, Wwrt, Wwrt, Wwrt, Wot, Wwrt, Ww, Wot, Wot
Wo, Wwt, Wwrt, Wwt^Vm, Wwrt, Wwt, Wwrt, Ds, Wwrt, Wwrt, Wwrt, Wwrt, Wwt, Wwt, Wwrt, Wwrt, Wwrt, Wot, Wot, Wwt, Wwt, Wot, Wwt, Wot, Wwrt, Wot, Wot, Wwrt, Ww^Vm, Wwrt, Wo
Wwrt, Wwt, Wwrt, Wwrt, Wot, Wwrt, Wot, Wwrt, Wot, Wot, Wwrt, Wot, Wwt, Dd, Wwrt, Wwrt, Wwrt, Wot, Wwrt, Wwrt, Dd, Wwt, Wwrt, Wot, Wwrt, Wwrt, Wot, Wot, Wot, Wot, Wot
Wwrt, Wwrt, Wwrt, Wot, Wot, Wot, Wwrt, Wwrt, Wwrt, Wwrt, Ww^Vm, Wwrt, Wwrt, Wwrt, Wwrt, Wot, Wot, Wwrt, Wwt, Wwrt, Wot, Wot, Wwrt, Wwrt, Wwrt, Wwrt, Wwrt, Wwrt, Wot, Wot, Wot
Wwrt, Wwrt, Wwrt, Wot, Wot, Wot, Wot, Wwrt, Wwt, Wwrt, Wwrt, Wwrt, Wwrt, Wwt, Dd, Wwrt, Wot, Wot, Wwt, Wwrt, Wwrt, Wwrt, Wwt, Wwt, Wot, Wot, Wot, Wot, Wot, Wot, Wot
Wot, Wwt, Wwrt, Wwrt, Cwz, Chw, Cwz, Wwrt, Wot, Dd, Wwrt, Wot, Wot, Wwt, Wwt, Wwrt, Wot, Wot, Wot, Wwt, Wwrt, Wwrt, Wot, Wwrt, Wot, Wot, Wot, Wwrt, Wwrt, Wot, Wot
Wot, Wot, Wot, Wwrt, Cwz, 2 Khw, Chw, Wot, Wwrt, Wwrt, Wot, Wot, Wwt, Wwt, Wwrt, Wot, Wot, Wot, Wot, Wwrt, Wot, Wot, Wwrt, Wot, Wot, Ww^Vm, Wwrt, Wwrt, Wot, Wot, Wot
Wot, Wot, Wot, Wwrt, Wwrt, Chw, Wot, Wwrt, Wwrt, Wwrt, Wwrt, Wot, Wot, Wwrt, Wwrt, Ww^Vm, Wot, Wot, Wwrt, Wwrt, Wot, Wot, Wwrt, Wot, Wot, Wot, Wwrt, Wwrt, Wot, Wot, Wot
Wot, Wot, Wwrt, Wwrt, Wot, Wot, Wot, Wot, Wot, Wot, Wwrt, Wot, Wot, Wot, Wot, Wot, Wot, Wot, Wwrt, Wwrt, Wwrt, Wot, Wot, Wot, Wot, Wwrt, Wwrt, Wwrt, Wwrt, Wot, Wot
Wot, Wot, Wo, Wwrt, Wot, Wot, Wot, Wot, Wot, Wot, Wo, Wot, Wot, Wot, Wot, Wot, Wot, Wot, Wot, Wot, Wot, Wot, Wot, Wot, Wot, Wot, Wot, Wot, Wot, Wot, Wot
