border_size=1
usage=map

Gg^Ftp, Dd^Ftd, Ds^Ftd, Dd^Ftd, Dd^Ftd, Dd^Ftd, Dd^Ftd, Ds, Ds, Wwt, Wwt, Wot, Wot, Wot, Wot, Wot, Wot, Wot, Wot, Wot, Wot, Wot, Wot, Wo, Wot, Wot, Wot, Wo, Wwt, Wot, Wot, Wot, Wot, Wot, Wot, Wot, Wwt, Wot, Wot, Wot
Gs^Ftp, Gg^Ftp, Gg^Ftp, Ds^Ftd, Hd^Ftd, Dd^Ftd, Dd^Ftd, Dd^Ftd, Dd^Ftd, Ds, Wwt, Wwt, Wwt, Wwt, Wwt, Wot, Wwt, Wot, Wot, Wot, Wot, Wot, Wot, Ww^Vm, Wwt, Wot, Wwt, Wwt, Wwt, Wot, Wot, Wot, Wot, Wot, Wwt, Wwt, Dd, Wwt, Wot, Wot
Gg^Ftd, Gg^Ftd, Gg^Ftp, Gg^Ftp, Gg^Ftp, Gs^Ft, Hd^Ftd, Ce, Dd^Ftd, Gs^Ftp, Gs^Ftp, Ww, Ww, Ww, Ss, Wwt, Ss, Wwt, Wot, Wot, Wot, Wot, Wwt, Wwt, Wwf, Wwt, Dd, Wwf, Wwrt, Wwrt, Wwrt, Wwrt, Wwrt, Wot, Wwt, Wwrt, 1 Dd, Wwt, Wot, Wot
Gd^Fet, Gs, Hh^Es, Gg^Ftp, Hh^Vdze, Gg^Ftp, Gs^Ftp, Gs^Ftp, Hh^Ftp, Hh^Ftp, Gs^Ft, Ww, Ss, Ss, Gs^Ftp, Gs^Ftp, Gs^Ftp, Wwt, Wwt, Wwt, Wwrt, Wot, Wwrt, Wwf, Wwf, Dd, Dd, Wwrt, Wwrt, Wot, Wot, Wwrt, Wwrt, Wwt, Wwrt, Dd, Wwt, Wwt, Wot, Wot
Gd, Gs, Hh^Es, Hh^Es, Hh^Fdw, Hh^Es, Hh^Ft, Hh^Ftp, Gs^Ft, Gs^Ft, Ww, Ww, Gs^Ft, Ss, Gs^Ft, Hh^Vdzc, Gs^Ftp, Ss, Dd, Wwrt, Wwrt, Wwrt, Wwt, Wwf, Wwt, Wwf, Wwt, Dd, Wwrt, Wot, Wot, Wot, Wwrt, Wwrt, Wwf, Wwt, Wot, Wot, Wot, Wot
Gs^Fdw, Hh^Es, Mm, Hh^Es, Hh^Fdw, Hh^Fp, Mm, Hh^Ftp, Ss, Ss, Ww, Ds, Gs^Ft, Ss, Gs^Ft, Hh^Ftp, Hh^Ft, Gs^Ftp, Dd, Wwf, Wwf, Wwt, Wot, Wwt, Wot, Wwt, Wot, Wwt, Wwt, Wwt, Wwt^Vm, Wot, Wwrt, Wwf, Wwt, Wwt, Wwt, Wot, Wot, Wot
Hh^Fdw, Hh^Fdw, Mm, Hh^Fdw, Mm, Hh^Fp, Hh^Fp, Hh^Fp, Hh^Fp, Ww, Hh^Fp, Ss, Ss, Ss, Ss, Gs^Ft, Hh^Ft, Gs^Ftp, Gs^Ft, Dd, Wwf, Wwt, Wot, Wot, Wot, Wot, Wot, Wot, Wwt, Wwt, Wwt, Wwrt, Wwf, Wwrt, Wwt, Wot, Wot, Wot, Wot, Wot
Rp, Hh^Fp, Hh, Hh^Fp, Rp, Rp, Rp, Mm, Hh^Fp, Ss, Hh^Fp, Hh^Fp, Gs^Ft, Ss, Ss, Gs^Ft, Gs^Ft, Hh^Ft, Gs^Ftp, Dd, Dd, Wwt, Wwt, Wot, Wwrt, Wwrt, Wot, Wot, Wot, Wot, Wwrt, Wwrt, Wwrt, Wwrt, Wwt, Wwt, Wwt, Wot, Wot, Wot
Rp, Hh^Fp, Mm, Rp, Ch, Ch, Ch, Rp^Fet, Mm, Mm, Mm, Hh^Fp, Gs, Gs^Ft, Gs^Ft, Ss, Gs^Ft, Gs^Ftp, Gs^Ftp, Gs^Ftp, Gs^Ftp, Wwf, Wwt, Wot, Wot, Wwrt, Wwrt, Wot, Wwrt, Wot, Wwrt, Wwt, Wwt, Dd, Dd^Vdzb, Dd, Wwt, Wot, Wot, Wot
Rp, Rp, Rp, Rp, Ch, 2 Kh, Ch, Rp, Mm, Mm^Vdzb, Mm, Hh^Fp, Gs, Gs, Gs^Ft, Ss, Ss, Ss, Gs^Ftp, Ce, Ss, Wwf, Wwf, Wwt, Wwrt, Wwrt, Wot, Wwrt, Wot, Wwrt, Wwt, Wwrt, Wwrt, Dd, Wwt, Wwt, Wot, Wot, Wot, Wot
Rp, Rp, Rp, Rp, Rp, Ch, Rp, Rp, Mm, Mm, Mm, Hh^Fp, Gs, Gs^Ft, Gs^Ft, Gs^Ft, Gs, Ss, Ss, Cwz, 3 Ke, Dd^Ftd, Wwf, Wwrt, Wwrt, Wwt, Wot, Wot, Wot, Wot, Wwrt, Wwt, Wwrt, Wwt, Wwt, Wot, Wot, Wot, Wot, Wot
Mm, Mm, Rp, Rp, Rp, Rp, Rp, Rp, Mm, Mm, Mm, Hh^Es, Gg^Es, Gs^Ft, Gs^Ft, Gs, Gs^Ft, Gs^Vdzd, Ss, Cwz, Ce, Dd^Ftd, Dd^Ftd, Wwf, Wwt, Wwrt, Wwrt, Wwrt, Wwrt, Wwrt^Vm, Wwf, Wwf, Wsz, Wsz, Wdz, Wot, Wot, Wot, Wot, Wot
Mm, Rp^Vdza, Rp, Rp, Rp, Rp, Mm, Mm, Mm, Hh^Fp, Hh^Fp, Hh^Es, Gs, Gs^Ft, Gg, Gs, Gs^Ft, Dd^Ftd, Ds^Ftd, Dd^Ftd, Dd^Ftd, Dd^Ftd, Ds, Wwt, Wot, Wot, Wot, Wwrt, Wwt, Wwrt, Wwt, Wwrt, Wdz, 4 Wdz^Kwy, Wdz, Wot, Wot, Wwt, Wot, Wwt
Mm, Mm, Mm, Rp, Rp, Rp, Rp, Mm, Mm, Hh^Fp, Gg, Gs, Gs, Gs, Gs, Gs^Ft, Hd^Ftd, Gs^Ft, Hd^Ftd, Hd^Ftd, Dd, Dd, Ds, Wwt, Wwt, Wot, Wot, Wwrt, Wwrt, Dd, Wwt, Wot, Wot, Wdz, Wot, Wot, Wot, Wot, Wot, Wwt
Hh^Fp, Mm, Mm, Rp, Rp, Rp, Rp^Fet, Mm, Hh^Fp, Hh^Fp, Gg, Gs^Ft, Gs^Ft, Gs, Hh^Es, Hh^Es, Mm, Hd^Ftd, Dd^Es, Dd^Es, Dd^Es, Dd^Dr, Dd, Ds, Wwt, Wot, Wot, Wot, Wot, Wwt, Dd, Wwt, Wot, Wot, Wot, Wot, Wot, Wwt^Vm, Wwt, Wot
Hh^Fp, Mm, Mm, Mm, Mm, Rp^Vdzc, Mm, Gs^Fp, Gs^Fp, Gg, Gs^Ft, Gs^Ft, Gs, Gs, Hh^Ft, Mm, Hd^Es, Hd^Es, Dd^Es, Dd^Es, Dd^Es, Dd, Dd^Vdze, Ds, Ds, Wwt, Wot, Wot, Wot, Wwt, Wwt, Wwt, Wot, Wot, Wot, Wot, Wot, Wot, Wot, Wot
Ww, Hh^Fp, Mm, Mm^Xm, Mm, Mm, Hh^Fp, Hh^Fp, Gg, Gg, Gs, Gs, Gs^Ftp, Gs^Ftp, Hh^Ftp, Mm, Hd^Ftd, Dd^Es, Dd^Ftd, Dd, Dd^Es, Dd^Es, Dd, Dd, Ds, Wwt, Wot, Wot, Wot, Wot, Wot, Wot, Wot, Wot, Wot, Wot, Wot, Wot, Wot, Wot
Ww, Hh^Fp, Mm, Mv, Mm, Hh^Fp, Hh^Ft, Gs, Gs^Ft, Gg, Gs^Ftp, Gs^Ftp, Gs^Ftp, Gs^Ftp, Gs^Ftp, Hh^Ftp, Dd^Ftd, Gs^Ft, Dd, Dd, Dd, Dd, Dd^Ftd, Dd^Ftd, Wwt, Wwt, Wot, Wot, Wot, Wot, Wot, Wot, Wot, Wot, Wot, Wot, Wot, Wot, Wot, Wot
Ww, Hh^Ft, Mm, Mm, Mm, Hh^Ft, Hh^Ft, Gg, Gs^Ft, Gs^Ftp, Hh^Ftp, Hh^Ftp, Hh^Ftp, Hh^Ftp, Hh^Ftp, Gs^Ftp, Dd^Es, Dd^Ftd, Dd, Dd^Ftd, Dd, Dd, Ds, Dd^Ftd, Wwt, Wwt, Wot, Wot, Wwrt, Wot, Wot, Wot, Wwrt, Wot, Wot, Wot, Wot, Wot, Wot, Wot
Gs^Ft, Gs^Ft, Mm, Mm^Xm, Mm, Hh^Ft, Gs^Ftp, Gs^Ftp, Ss, Gs^Ftp, Hh^Ftp, Hh^Ftp, Mm, Mm, Hh^Ftp, Dd^Ftd, Dd^Es, Dd^Es, Dd^Es, Dd, Dd^Dr, Ds, Wwf, Wwt, Wot, Wot, Wwrt, Wwrt, Wwrt, Wwrt, Wot, Wot, Wot, Wwt, Wot, Wot, Wot, Wot, Wwt, Wot
Gs^Ftp, Gs^Ft, Mm, Mm, Mm, Hh^Ft, Gs^Ft, Ss, Gs^Ftp, Ss, Gs^Ftp, Hh^Ftp, Hd^Ftd, Hh^Ftp, Hh^Ftp, Dd^Ftd, Dd^Es, Dd^Es, Dd^Vdzc, Dd, Ds, Ds, Wwf, Wwt, Wwt, Wot, Wot, Wot, Wot, Wot, Wot, Wot, Wot, Wot, Wot, Wot, Wwt, Wwt, Dd^Vdze, Wwt
Gs^Ftp, Hh^Ft, Mm, Mm, Hh^Ft, Hh^Ft, Gs^Ftp, Ss, Gs^Ftp, Gs^Ftp, Gs^Ftp, Gs^Ft, Dd^Ftd, Gs^Ft, Gs^Ft, Gs^Ft, Dd, 5 Ke, Ce, Ds, Wwf, Wwf, Wwt, Wwf, Wwt, Wot, Wot, Wot, Wot, Wot, Wwt^Vm, Wot, Wot, Wot, Wot, Wwt, Wwt, Dd, Wwt, Wot
Hh^Ft, Hh^Ft, Mm, Hh^Ft, Gs^Ft, Gs^Ft, Ww^Ewl, Ss, Gs^Ftp, Gs^Vdzd, Gs^Ftp, Dd^Ftd, Dd^Ftd, Dd^Ftd, Dd, Dd, Ds, Ce, Ds, Ds, Wwf, Wwf, Wwt, Wwt, Wot, Wot, Wot, Wot, Wwt, Wwt, Wwrt, Wot, Wot, Wot, Wot, Wot, Wwt, Wwt, Wwt, Wot
Mm, Mm, Hh^Ft, Hh^Ft, Gs^Ftp, Gs^Ftp, Gs^Ftp, Ss, Ss, Gs^Ftp, Gs^Ftp, Gs^Ftp, Dd^Ftd, Dd^Ftd, Ds, Ds, Wwf, Ds, Wwf, Wwf, Wwf, Wwt, Wot, Wot, Wot, Wot, Wot, Wwrt, Wwrt, Wwrt, Wwrt, Wwrt, Wot, Wot, Wot, Wot, Wot, Wot, Wot, Wot
Hh^Ft, Hh^Ft, Gs^Ft, Gs^Ft, Gs^Ftp, Gs^Ftp, Gs^Ftp, Ss, Ss, Gs^Ftp, Ss, Gs^Ftp, Wwf, Wwf, Wwt, Wwf, Wwt, Wwf, Wwt, Wwt, Wwt, Wwt, Wot, Wot, Wot, Wot, Wot, Wot, Wot, Wot, Wot, Wot, Wwrt, Wot, Wot, Wot, Wot, Wot, Wot, Wot
Gs^Ft, Gs^Ft, Gs^Ftp, Gs^Ftp, Ss, Gs^Ftp, Ww, Gs^Ftp, Ww, Ww, Ww, Ww, Wwt, Wwt, Wwt, Wwt, Wwt, Wwt, Wot, Wot, Wot, Wot, Wot, Wot, Wot, Wot, Wot, Wot, Wot, Wot, Wot, Wwrt, Wwrt, Wwrt, Wwrt, Wot, Wot, Wot, Wot, Wot
Gs^Ftp, Gs^Ftp, Gs^Ftp, Ss, Ww, Ww, Wwt, Ww, Wwt, Wwt, Wwt, Wwt, Wwt, Wwt, Wot, Wwt, Wwt, Wot, Wot, Wot, Wwt, Wot, Wot, Wot, Wot, Wot, Wwrt, Wot, Wot, Wot, Wot, Wot, Wot, Wot, Wot, Wot, Wot, Wot, Wot, Wot
Gs^Ftp, Gs^Vdze, Ss, Ww, Wwrt, Wwt, Wot, Wwt, Wwt, Wwt, Wot, Wwt, Wot, Wwt, Wot, Wot, Wot, Wot, Wot, Wot, Wwt^Vm, Wwrt, Wot, Wot, Wwt, Wwrt, Wot, Wot, Wot, Wot, Wot, Wot, Wot, Wot, Wot, Wot, Wot, Wot, Wot, Wot
Gs^Ftp, Gs^Ftp, Wwt, Wwt, Wwrt, Wwt, Wwt, Wwt, Wot, Wwt, Wot, Wot, Wot, Wot, Wot, Wot, Wwt, Wot, Wot, Wwt, Wot, Wwrt, Wot, Wwt, Ds, Wwt, Wot, Wot, Wot, Wwrt, Wwrt, Wot, Wot^Vm, Wot, Wot, Wot, Wot, Wot, Wot, Wot
Gs^Ftp, Gs^Ftp, Wwt, Wwrt, Wwrt, Wwt, Wwrt, Wwt, Wwt, Wot, Wwt, Wot, Wwt, Wwt, Wwt, Wot, Wwt, Wot, Wwt, Wot, Wwrt, Wot, Wot, Wwrt, Dd, Wwt, Wot, Wot, Wot, Wot, Wot, Wot, Wot, Wot, Wot, Wot, Wot, Wot, Wot, Wot
Gs^Ftp, Wwt, Wwrt, Wwt, Wwrt, Wwrt, Wwrt, Wwrt, Wwt, Wwt, Wwt, Wwt, Wwt, Wwrt, Wwt, Wwt, Wwrt, Wwt, Wot, Wot, Wot, Wwrt, Wwrt, Wwrt, Wwrt, Wwrt, Wot, Wot, Wwrt, Wot, Wot, Wot, Wot, Wot, Wwrt, Wot, Wot, Wot, Wot, Wot
Wwt, Wwt, Wwrt, Wwt, Wwrt, Wwrt, Wwrt, Wwrt, Dd^Ftd, Dd^Ftd, Dd^Ftd, Wwrt, Wwt, Wwrt, Wwt, Wwrt, Wwrt, Wwrt, Wwt, Wwt, Wwt, Wwrt, Wwrt, Wwrt, Wwrt, Wot, Wot, Wwrt, Wwrt, Wot, Wot, Wot, Wwrt, Wot, Wwrt, Wwrt, Wot, Wot, Wot, Wot
Wwt, Wwt, Wwrt, Wwrt, Wwt, Wwt, Wwt, Dd, Dd^Vhs, Ce, Dd^Ftd, Wwrt, Wwrt, Wwrt, Wwrt, Wwrt, Wwt, Wot, Wwrt, Wwrt, Wot, Wot, Wot, Wot, Wot, Wot, Wot, Wot, Wot, Wot, Wot, Wot, Wot, Wwrt, Wot, Wwt, Wwrt, Wot, Wot, Wot
Wwt, Wwt, Wwt^Vm, Wwt, Wot, Wwt, Wot, Wwt, Dd^Ftd, Ce, Dd, Dd, Wwt, Wwt, Wwrt, Dd^Vhs, Wwt, Wot, Wot, Wwrt, Wwrt, Wwrt, Wot, Wot, Wot, Wot, Wot, Wot, Wot, Wot, Wot, Wot, Wot, Wot, Wot, Wot, Wwt^Vm, Wwt, Wot, Wot
Wwt, Wwt, Wwt, Wot, Wot, Wot, Wot, Wwt, Wwt, Dd, Wwt, Wwt, Wot, Wot, Wot, Wwt, Wot, Wot, Wot, Wwrt, Wot, Wot, Wot, Wot, Wot, Wot^Vm, Wot, Wot, Wot, Wot, Wot, Wot, Wot, Wot, Wot, Wot, Wot, Wwt, Wot, Wot
Wwt, Wwt, Wwt, Wot, Wot, Wot, Wot, Wot, Wwt, Wwt, Wot, Wot, Wot, Wot, Wot, Wot, Wot, Wot, Wot, Wot, Wot, Wot, Wot, Wot, Wot, Wot, Wot, Wot, Wot, Wot, Wot, Wot, Wot, Wot, Wot, Wot, Wot, Wot, Wot, Wot
