border_size=1
usage=map

Gg, Gg, Gs, Ss, Gs, Ww, Ww, Gs, Gs^Fds, Gs^Fds, Gs^Fds, Gs^Fmw, Gs^Fds, Gg, Gs^Fmw, Gg, Gg, Gg, Gg, Gg, Hh^Fds, Gs^Fmf, Gs^Fp, Gs^Ft, Gs^Ft, Gs^Ft, Ww, Ww
Re^Gvs, Gg, Gs^Fmw, Gs, Gs^Fmw, Gs, Ww, Gs, Gs^Fmw, Gs^Fmw, Gs^Fds, Hh^Vdza, Hh^Fds, Gs^Fds, Gs^Fds, Gs^Fds, Gs^Fds, Gg, Gg, Gs^Fp, Hh^Fds, Hh^Fp, Hh^Fp, Gs^Fp, Gs^Fds, Gs^Ft, Ww, Ds
Re^Gvs, Gg, Gg, Gs^Ft, Gs^Ft, Gs^Ft, Gs^Fmw, Ww, Ww, Gs^Fds, Gs^Fmw, Hh^Fds, Hh^Fds, Gs^Fds, Gs^Fds, Gs^Fds, Hh^Fds, Hh^Fds, Gs^Fds, Hh^Fds, Hh^Fp, Hh^Fp, Hh^Fp, Hh^Fp, Hh^Fp, Ww, Hh^Fp, Gs^Ft
Gg, Gg, Gg, Gs^Fmw, Gs^Fmw, Gs^Ft, Gs^Ft, Gs^Fmw, Gs^Fmw, Ww, Ww, Gs^Fds, Gs^Fds, Gs^Fds, Gg^Efm, Gg^Fet, Rp, Hh^Fp, Hh, Hh^Fp, Rp, Rp, Rp, Mm, Ss, Ww, Hh^Fp, Hh^Fp
Gg, Gg, Gg, Gg, Gg, Gg, Gs^Ft, Gs^Ft, Gs^Ft, Gs^Fmw, Ww, Hh^Fds, Hh^Fds, Gg^Efm, Gg^Efm, Gg^Efm, Rp, Hh^Fp, Mm, Rp, Ch, Ch, Ch, Rp, Mm, Mm, Mm, Hh^Fp
Gg, Gg^Vdzb, Gg, Gg, Gg, Gg, Gs, Gs^Ft, Gs^Ft, Gs^Ft, Gs^Ft, Ww, Hh^Fp, Gg^Efm, Hh^Fp, Gg^Efm, Rp, Rp, Rp, Rp, Ch, Kh, Ch, Rp, Mm, Mm^Vdzb, Mm, Hh^Fp
Gg, Gg, Gg, Gs^Fmw, Gs^Ft, Gs^Ft, Hh^Fmw, Gs, Gs^Ft, Gs^Ft, Gs^Ft, Ww, Ww, Hh^Fp, Rp, Rp, Rp, Rp, Rp, Rp, Rp, Ch, Rp, Rp, Mm, Mm, Mm, Hh^Fp
Gg, Gg, Gs^Ft, Gs^Ft, Hh^Fmw, Hh^Fmw, Mm, Hh^Fmw, Hh^Fmw, Gs^Ft, Hh^Fp, Hh^Fp, Ww, Hh^Fp, Hh^Fp, Mm, Mm^Vdze, Mm, Rp, Rp, 1 Rp, Rp, Rp, Rp, Mm, Mm, Mm, Hh^Fp
Gs, Gs, Gs^Ft, Hh^Fmw, Mm, Mm, Mv, Mm, Mm, Mm, Mm, Hh^Fp, Hh^Fp, Ww, Hh^Fp, Mm, Mm, Gs^Ft, Rp, Rp, Rp, Rp, Mm, Mm, Mm, Hh^Fp, Hh^Fp, Hh^Fp
Gs^Ft, Gs^Ft, Gs^Ft, Hh^Fms, Mm, Mm, Mm, Mm, Mm, Mm, Mm, Mm, Hh^Fp, Ww, Hh^Fp, Mm, Mm, Mm, Rp, Rp, Rp, Rp, Gg^Fet, Mm, Mm, Hh^Fp, Gs, Gs
Gs^Ft, Gs^Ft, Gs^Vdze, Gs^Ft, Gs^Ft, Mm, Mm, Mm, Mm, Mm, Mm, Mm, Hh^Fp, Ww, Ww, Hh^Fp, Mm, Mm, Mm, Rp, Rp, Rp^Vd, Gs^Fp, Mm, Hh^Fp, Hh^Fp, Gg, Gs
Gd^Fts, Gs^Ft, Gs^Ft, Gs^Ft, Gs^Ft, Hh^Fds, Hh^Fds, Mm, Mm, Mm, Mm, Mm, Mm, Hh^Fp, Ww, Hh^Fp, Hh^Fp, Mm, Mm, Mm, Mm, Gg^Fet, Mm, Gs^Fp, Gs^Fp, Gg, Gg, Gs^Ft
Gd^Fts, Gs^Ft, Gs^Ft, Gs^Ft, Gs^Ft, Gs^Ft, Gs^Ft, Hh^Fds, Hh^Fds, Mm, Mm, Mm, Mm, Hh^Fp, Hh^Fp, Ww, Hh^Fp, Hh^Fp, Mm, Mm^Xm, Mm, Mm, Hh^Fp, Hh^Fp, Gg, Gg, Gg, Gs^Ft
Gd^Fts, Gs^Ft, Gs^Ft, Gd^Fts, Gd^Fts, Gs^Ft, Gs^Ft, Gs^Ft, Gs^Ft, Gs^Fms, Mm, Mm, Mm, Hh^Fp, Gg^Vdzd, Ww, Gs^Ft, Hh^Fp, Mm, Mv, Mm, Hh^Fp, Hh^Ft, Gs^Ftd, Gs^Ft, Gg, Gs^Ft, Gs^Ft
Gd^Fts, Gd^Fts, Gd^Fts, Gd^Fts, Gd^Fts, Gs^Ft, Gd^Fts, Gd^Fts, Gs^Ft, Hh^Fds, Gs^Ft, Hh^Fds, Hh^Fds, Hh^Fp, Ww, Ww, Gs^Ft, Hh^Ft, Mm, Mm, Mm, Hh^Ft, Hh^Ft, Gg^Ftd, Gs^Ft, Gg^Vd, Gs^Ft, Gs^Ft
Gd^Fts, Gd^Fts, Gs^Ft, Gd^Fts, Gd^Fts, Gd^Fts, Gd^Fts, Gd^Fts, Gd^Fts, Gs^Ft, Gs^Ft, Gs^Ft, Gs^Ft, Hh^Fp, Ww, Gs^Ft, Gs^Ft, Hh^Ft, Mm, Mm^Xm, Hh^Ft, Hh^Ft, Gs^Ft, Gs^Ft, Gs^Ft, Gs^Ft, Gs^Ft, Gs^Ft
Gs^Ft, Gs^Ft, Ss, Ss, Ss, Gd^Fts, Ss, Gd^Fts, Gd^Fts, Gd^Fts, Gd^Fts, Gd^Fts, Gd^Fts, Gs^Ft, Ww, Ds, Gs^Ft, Hh^Ft, Mm, Mm, Hh^Ft, Gs^Ft, Gs^Ft, Gs^Ft, Gd^Ftd, Gs^Ft, Gs^Ft, Gs^Ft
Gs^Ft, Ss, Ss, 2 Ss, Ss, Ss, Ss, Ss, Ss, Ss, Ss, Gd^Fts, Ww, Ww, Gs^Ft, Gs^Ft, Hh^Ft, Hh^Ft, Mm, Mm, Hh^Ft, Gd^Ftd, Ds, Ds, Ds, Gs^Ft, Ds, Gs^Ft
Gs^Ft, Ss, Ss, Ss, Ww^Ewl, Ss, Ww, Ww^Ewl, Ww, Ww^Ewl, Ww, Ww, Wwt, Ww, Gs^Ft, Hh^Ft, Mm, Mm, Mm, Hh^Ft, Gs^Ft, Dd, Wwf, Wwf, Ds, Ds, Ds, Ds
Ss, Ss, Ss, Ss, Ww, Ww, Gs, Wwr, Gs^Ft, Wwt, Gs^Ft, Wwt, Gs^Ft, Gs^Ft, Hh^Ft, Hh^Ft, Mm, Mm, Hh^Ft, Hh^Ft, Gs^Ft, Wwf, Ww, Ww, Ww, Wwf, Wwf, Wwf
Ss, Ss, Ss, Ww, Ww, Gs, Gs^Ft, Gs^Ft, Gs^Ft, Gs^Ft, Gs^Ft, Gs^Ft, Hh^Ft, Hh^Ft, Mm, Mm, Hh^Ft, Hh^Ft, Gs^Ft, Gs^Ft, Ww, Ww, Ww, Ww, Ww, Ww, Ww, Ww